Country_Match,FH_Country,Status,Political_Rights_Rating,Civil_Liberties_Rating,Electoral_Process_Subcategory_A,Political_Pluralism_and_Participation_Subcategory_B,Function_of_Government_Subcategory_C,Political_Rights_Raw_Score_ABC,Freedom_of_Expression_and_Belief_Subcategory_D,Associational_and_Organizational_Rights_Subcategory_E,Rule_of_Law_Subcategory_F,Personal_Autonomy_and_Individual_Rights_Subcategory_G,Civil_Liberties_Raw_Score_DEFG,Total_Agg_Score,Year
Abkhazia,Abkhazia,Partly Free,5,5,5,8,4,17,8,6,4,5,23,40,2020
Afghanistan,Afghanistan,Not Free,5,6,3,7,3,13,6,4,2,2,14,27,2020
Albania,Albania,Partly Free,3,3,8,12,7,27,13,9,9,9,40,67,2020
Algeria,Algeria,Not Free,6,5,3,4,3,10,7,4,6,7,24,34,2020
Andorra,Andorra,Free,1,1,12,15,12,39,14,11,15,15,55,94,2020
Angola,Angola,Not Free,6,5,3,6,2,11,7,6,5,3,21,32,2020
Antigua and Barbuda,Antigua and Barbuda,Free,2,2,12,13,8,33,15,10,14,13,52,85,2020
Argentina,Argentina,Free,2,2,11,16,8,35,15,11,10,14,50,85,2020
Armenia,Armenia,Partly Free,4,4,6,10,5,21,9,8,6,9,32,53,2020
Australia,Australia,Free,1,1,12,16,12,40,15,12,15,15,57,97,2020
Austria,Austria,Free,1,1,12,15,10,37,14,12,15,15,56,93,2020
Azerbaijan,Azerbaijan,Not Free,7,6,0,2,0,2,2,1,0,5,8,10,2020
Bahamas,Bahamas,Free,1,1,12,16,10,38,15,12,13,13,53,91,2020
Bahrain,Bahrain,Not Free,7,6,2,0,2,1,2,1,1,6,10,11,2020
Bangladesh,Bangladesh,Partly Free,5,5,4,7,4,15,6,5,4,9,24,39,2020
Barbados,Barbados,Free,1,1,12,16,10,38,16,12,14,15,57,95,2020
Belarus,Belarus,Not Free,7,6,0,3,2,5,2,3,2,7,14,19,2020
Belgium,Belgium,Free,1,1,12,16,11,39,15,12,15,15,57,96,2020
Belize,Belize,Free,2,2,12,14,9,35,15,11,12,13,51,86,2020
Benin,Benin,Partly Free,4,2,5,9,7,21,15,9,11,10,45,66,2020
Bhutan,Bhutan,Partly Free,3,4,10,11,9,29,9,5,8,8,30,59,2020
Bolivia,Bolivia,Partly Free,3,3,8,10,7,25,14,8,6,10,38,63,2020
Bosnia and Herzegovina,Bosnia and Herzegovina,Partly Free,4,4,6,9,4,19,10,7,7,10,34,53,2020
Botswana,Botswana,Free,3,2,10,10,8,28,12,10,11,11,44,72,2020
Brazil,Brazil,Free,2,2,10,14,7,31,14,9,8,13,44,75,2020
Brunei,Brunei,Not Free,6,5,0,3,4,7,6,3,5,7,21,28,2020
Bulgaria,Bulgaria,Free,2,2,11,14,9,34,13,11,10,12,46,80,2020
Burkina Faso,Burkina Faso,Partly Free,4,4,7,10,6,23,11,8,6,8,33,56,2020
Burundi,Burundi,Not Free,7,6,0,3,0,3,4,1,1,4,10,13,2020
Cape Verde,Cabo Verde,Free,1,1,12,16,10,38,16,11,14,13,54,92,2020
Cambodia,Cambodia,Not Free,7,5,1,2,2,5,8,3,3,6,20,25,2020
Cameroon,Cameroon,Not Free,6,6,1,3,3,7,4,2,1,4,11,18,2020
Canada,Canada,Free,1,1,12,16,12,40,15,12,15,16,58,98,2020
Central African Republic,Central African Republic,Not Free,7,7,3,2,0,4,4,1,1,0,6,10,2020
Chad,Chad,Not Free,7,6,1,1,1,3,6,4,1,3,14,17,2020
Chile,Chile,Free,1,2,12,15,11,38,15,10,13,14,52,90,2020
China,China,Not Free,7,6,0,0,2,-1,1,2,2,6,11,10,2020
Colombia,Colombia,Partly Free,3,3,10,11,8,29,12,6,9,10,37,66,2020
Comoros,Comoros,Partly Free,4,4,6,8,4,18,8,6,6,6,26,44,2020
Congo,Congo (Brazzaville),Not Free,7,5,0,2,0,2,7,4,1,6,18,20,2020
DR Congo,Congo (Kinshasa),Not Free,7,6,1,2,1,4,7,3,0,4,14,18,2020
Costa Rica,Costa Rica,Free,1,1,12,15,11,38,16,11,13,13,53,91,2020
Cote d'Ivoire,Cote d'Ivoire,Partly Free,4,4,7,8,4,19,11,8,6,7,32,51,2020
Crimea,Crimea,Not Free,7,6,0,0,0,-2,3,1,0,6,10,8,2020
Croatia,Croatia,Free,1,2,12,14,10,36,13,12,11,13,49,85,2020
Cuba,Cuba,Not Free,7,6,0,0,1,1,5,0,2,6,13,14,2020
Cyprus,Cyprus,Free,1,1,12,15,11,38,15,12,15,14,56,94,2020
Czech Republic,Czech Republic,Free,1,1,12,15,9,36,14,12,14,15,55,91,2020
Denmark,Denmark,Free,1,1,12,16,12,40,16,12,14,15,57,97,2020
Djibouti,Djibouti,Not Free,7,5,2,3,0,5,6,3,4,6,19,24,2020
Dominica,Dominica,Free,1,1,11,16,10,37,15,11,15,15,56,93,2020
Dominican Republic,Dominican Republic,Partly Free,3,3,9,10,7,26,14,10,8,9,41,67,2020
#N/A,Eastern Donbas,Not Free,7,7,0,0,0,-1,2,0,0,4,6,5,2020
Ecuador,Ecuador,Partly Free,3,3,8,12,7,27,12,8,8,10,38,65,2020
Egypt,Egypt,Not Free,6,6,2,3,2,7,4,1,3,6,14,21,2020
El Salvador,El Salvador,Partly Free,2,4,11,13,8,32,11,8,7,8,34,66,2020
Equatorial Guinea,Equatorial Guinea,Not Free,7,7,0,0,0,0,3,0,0,3,6,6,2020
Eritrea,Eritrea,Not Free,7,7,0,0,1,1,0,0,0,1,1,2,2020
Estonia,Estonia,Free,1,1,12,15,11,38,16,12,14,14,56,94,2020
Eswatini,Eswatini,Not Free,7,5,0,1,0,1,5,3,5,5,18,19,2020
Ethiopia,Ethiopia,Not Free,6,6,2,5,3,10,4,4,2,4,14,24,2020
Fiji,Fiji,Partly Free,3,3,8,9,7,24,12,7,7,10,36,60,2020
Finland,Finland,Free,1,1,12,16,12,40,16,12,16,16,60,100,2020
France,France,Free,1,2,12,15,11,38,14,11,13,14,52,90,2020
Gabon,Gabon,Not Free,7,5,0,2,1,3,8,3,3,5,19,22,2020
Gaza Strip,Gaza Strip,Not Free,7,6,0,2,1,3,4,2,0,2,8,11,2020
Georgia,Georgia,Partly Free,3,3,8,9,7,24,10,7,8,12,37,61,2020
Germany,Germany,Free,1,1,12,15,12,39,14,12,14,15,55,94,2020
Ghana,Ghana,Free,2,2,12,13,10,35,14,11,11,11,47,82,2020
Greece,Greece,Free,1,2,12,15,10,37,14,12,11,14,51,88,2020
Grenada,Grenada,Free,1,2,11,16,10,37,15,11,13,13,52,89,2020
Guatemala,Guatemala,Partly Free,4,4,7,10,4,21,11,6,6,8,31,52,2020
Guinea,Guinea,Partly Free,5,5,5,7,3,15,11,4,4,6,25,40,2020
Guinea-Bissau,Guinea-Bissau,Partly Free,5,4,7,8,2,17,11,8,5,5,29,46,2020
Guyana,Guyana,Free,2,3,10,13,8,31,15,11,8,9,43,74,2020
Haiti,Haiti,Partly Free,5,5,5,7,4,16,10,3,4,5,22,38,2020
Honduras,Honduras,Partly Free,4,4,7,8,4,19,9,4,5,8,26,45,2020
Hong Kong,Hong Kong,Partly Free,5,3,2,8,6,16,10,6,10,13,39,55,2020
Hungary,Hungary,Partly Free,3,3,9,11,7,27,10,10,10,13,43,70,2020
Iceland,Iceland,Free,1,1,12,15,10,37,15,12,15,15,57,94,2020
India,India,Free,2,3,12,13,9,34,10,8,9,10,37,71,2020
Indian Kashmir,Indian Kashmir,Not Free,6,5,2,4,2,8,6,3,4,7,20,28,2020
Indonesia,Indonesia,Partly Free,2,4,11,13,6,30,10,7,5,9,31,61,2020
Iran,Iran,Not Free,6,6,3,2,2,7,2,1,3,4,10,17,2020
Iraq,Iraq,Not Free,5,6,8,8,2,17,5,4,1,4,14,31,2020
Ireland,Ireland,Free,1,1,12,16,11,39,16,12,14,16,58,97,2020
Israel,Israel,Free,2,3,12,13,8,33,12,9,11,11,43,76,2020
Italy,Italy,Free,1,1,12,14,10,36,15,12,12,14,53,89,2020
Jamaica,Jamaica,Free,2,2,12,13,9,34,15,10,8,11,44,78,2020
Japan,Japan,Free,1,1,12,16,12,40,15,12,15,14,56,96,2020
Jordan,Jordan,Partly Free,5,5,3,6,3,12,7,3,7,8,25,37,2020
Kazakhstan,Kazakhstan,Not Free,7,5,1,3,1,5,4,2,4,8,18,23,2020
Kenya,Kenya,Partly Free,4,4,6,8,5,19,10,7,5,7,29,48,2020
Kiribati,Kiribati,Free,1,1,12,15,10,37,16,12,15,13,56,93,2020
Kosovo,Kosovo,Partly Free,3,4,9,11,5,25,9,8,6,8,31,56,2020
Kuwait,Kuwait,Partly Free,5,5,2,7,4,13,6,4,7,6,23,36,2020
Kyrgyzstan,Kyrgyzstan,Partly Free,5,4,4,5,4,12,10,6,4,7,27,39,2020
Laos,Laos,Not Free,7,6,0,0,2,2,4,0,2,6,12,14,2020
Latvia,Latvia,Free,1,2,12,15,10,37,14,12,12,14,52,89,2020
Lebanon,Lebanon,Partly Free,5,4,5,7,2,14,11,8,5,6,30,44,2020
Lesotho,Lesotho,Partly Free,3,3,10,11,6,27,12,7,8,9,36,63,2020
Liberia,Liberia,Partly Free,3,4,8,12,7,27,11,7,6,9,33,60,2020
Libya,Libya,Not Free,7,6,0,1,0,1,4,2,0,2,8,9,2020
Liechtenstein,Liechtenstein,Free,2,1,10,13,10,33,16,12,14,15,57,90,2020
Lithuania,Lithuania,Free,1,1,12,16,10,38,16,11,12,14,53,91,2020
Luxembourg,Luxembourg,Free,1,1,12,16,10,38,16,12,16,16,60,98,2020
Madagascar,Madagascar,Partly Free,3,3,9,11,6,26,11,9,7,8,35,61,2020
Malawi,Malawi,Partly Free,3,3,8,12,6,26,13,7,9,7,36,62,2020
Malaysia,Malaysia,Partly Free,4,4,6,9,6,21,9,6,7,9,31,52,2020
Maldives,Maldives,Partly Free,4,5,7,7,4,18,3,6,6,7,22,40,2020
Mali,Mali,Partly Free,5,5,5,8,4,17,10,6,4,4,24,41,2020
Malta,Malta,Free,2,1,12,14,9,35,14,12,15,14,55,90,2020
Marshall Islands,Marshall Islands,Free,1,1,12,16,10,38,16,11,15,13,55,93,2020
Mauritania,Mauritania,Partly Free,5,5,6,3,4,13,9,4,4,4,21,34,2020
Mauritius,Mauritius,Free,1,2,12,15,10,37,15,12,13,12,52,89,2020
Mexico,Mexico,Partly Free,3,3,9,13,5,27,13,7,5,10,35,62,2020
Micronesia,Micronesia,Free,1,1,12,15,10,37,16,11,15,13,55,92,2020
Moldova,Moldova,Partly Free,3,4,9,12,5,26,11,8,6,9,34,60,2020
Monaco,Monaco,Free,3,1,8,10,8,26,16,12,14,15,57,83,2020
Mongolia,Mongolia,Free,1,2,11,16,9,36,14,11,11,12,48,84,2020
Montenegro,Montenegro,Partly Free,4,3,8,9,5,22,11,9,9,11,40,62,2020
Morocco,Morocco,Partly Free,5,5,5,5,3,13,7,5,5,7,24,37,2020
Mozambique,Mozambique,Partly Free,5,4,3,7,4,14,9,6,7,9,31,45,2020
Myanmar,Myanmar,Not Free,5,6,5,9,4,14,5,6,1,4,16,30,2020
Nagorno-Karabakh,Nagorno-Karabakh,Partly Free,5,5,4,6,3,13,7,5,4,5,21,34,2020
Namibia,Namibia,Free,2,2,11,12,8,31,14,11,11,10,46,77,2020
Nauru,Nauru,Free,2,3,12,14,8,34,13,9,9,12,43,77,2020
Nepal,Nepal,Partly Free,3,4,10,10,5,25,10,7,6,8,31,56,2020
Netherlands,Netherlands,Free,1,1,12,16,12,40,16,12,15,16,59,99,2020
New Zealand,New Zealand,Free,1,1,12,16,12,40,16,12,14,15,57,97,2020
Nicaragua,Nicaragua,Not Free,6,5,3,4,3,10,7,2,4,8,21,31,2020
Niger,Niger,Partly Free,4,4,6,8,6,20,10,6,6,6,28,48,2020
Nigeria,Nigeria,Partly Free,4,5,6,10,6,22,9,7,4,5,25,47,2020
North Korea,North Korea,Not Free,7,7,0,0,0,0,0,0,0,3,3,3,2020
Macedonia,North Macedonia,Partly Free,3,3,7,11,6,24,12,8,9,10,39,63,2020
Northern Cyprus,Northern Cyprus,Free,2,2,11,13,7,31,15,11,13,11,50,81,2020
Norway,Norway,Free,1,1,12,16,12,40,16,12,16,16,60,100,2020
Oman,Oman,Not Free,6,5,2,2,2,6,5,3,4,5,17,23,2020
Pakistan,Pakistan,Partly Free,5,5,5,6,5,16,6,6,4,6,22,38,2020
Pakistani Kashmir,Pakistani Kashmir,Not Free,6,5,4,4,3,9,6,4,3,6,19,28,2020
Palau,Palau,Free,1,1,12,15,10,37,16,11,15,13,55,92,2020
Panama,Panama,Free,1,2,12,15,9,36,15,11,10,12,48,84,2020
Papua New Guinea,Papua New Guinea,Partly Free,4,3,7,13,3,23,14,10,7,8,39,62,2020
Paraguay,Paraguay,Partly Free,3,3,10,12,6,28,12,8,7,10,37,65,2020
Peru,Peru,Free,2,3,11,13,6,30,15,8,8,11,42,72,2020
Philippines,Philippines,Partly Free,3,4,9,10,6,25,14,7,3,10,34,59,2020
Poland,Poland,Free,2,2,11,16,8,35,14,10,11,14,49,84,2020
Portugal,Portugal,Free,1,1,12,16,11,39,16,12,14,15,57,96,2020
Qatar,Qatar,Not Free,6,5,2,2,3,7,7,2,5,4,18,25,2020
Romania,Romania,Free,2,2,12,14,9,35,13,11,12,12,48,83,2020
Russia,Russia,Not Free,7,6,0,3,2,5,3,3,2,7,15,20,2020
Rwanda,Rwanda,Not Free,6,6,2,2,4,8,3,2,2,7,14,22,2020
Samoa,Samoa,Free,2,2,9,12,9,30,14,11,14,12,51,81,2020
San Marino,San Marino,Free,1,1,12,15,11,38,15,12,15,15,57,95,2020
Sao Tome and Principe,Sao Tome and Principe,Free,2,2,11,15,9,35,15,11,12,11,49,84,2020
Saudi Arabia,Saudi Arabia,Not Free,7,7,0,0,1,1,2,0,2,2,6,7,2020
Senegal,Senegal,Partly Free,3,3,9,12,8,29,13,9,9,11,42,71,2020
Serbia,Serbia,Partly Free,4,3,8,10,5,23,12,10,9,12,43,66,2020
Seychelles,Seychelles,Partly Free,3,3,10,11,8,29,12,9,11,11,43,72,2020
Sierra Leone,Sierra Leone,Partly Free,3,3,10,11,7,28,12,6,9,10,37,65,2020
Singapore,Singapore,Partly Free,4,4,4,8,7,19,8,4,7,12,31,50,2020
Slovakia,Slovakia,Free,1,2,12,15,9,36,14,12,12,14,52,88,2020
Slovenia,Slovenia,Free,1,1,12,16,11,39,14,12,15,14,55,94,2020
Solomon Islands,Solomon Islands,Free,2,2,9,14,7,30,16,10,11,12,49,79,2020
Somalia,Somalia,Not Free,7,7,0,1,0,1,3,3,0,0,6,7,2020
Somaliland,Somaliland,Partly Free,5,5,5,8,4,17,6,5,7,6,24,41,2020
South Africa,South Africa,Free,2,2,12,13,8,33,15,12,9,10,46,79,2020
South Korea,South Korea,Free,2,2,11,13,9,33,14,11,12,13,50,83,2020
South Ossetia,South Ossetia,Not Free,7,6,2,2,0,2,3,1,1,3,8,10,2020
South Sudan,South Sudan,Not Free,7,7,1,1,0,-2,2,2,0,0,4,2,2020
Spain,Spain,Free,1,1,12,16,10,38,14,11,14,15,54,92,2020
Sri Lanka,Sri Lanka,Partly Free,4,4,9,10,5,23,8,9,8,8,33,56,2020
St. Kitts and Nevis,St. Kitts and Nevis,Free,1,1,10,16,10,36,15,12,13,13,53,89,2020
St. Lucia,St. Lucia,Free,1,1,11,16,11,38,15,12,13,14,54,92,2020
St. Vincent and the Grenadines,St. Vincent and the Grenadines,Free,1,1,11,15,10,36,15,12,14,14,55,91,2020
Sudan,Sudan,Not Free,7,6,0,4,0,2,5,3,1,1,10,12,2020
Suriname,Suriname,Free,2,3,11,14,7,32,14,11,8,10,43,75,2020
Sweden,Sweden,Free,1,1,12,16,12,40,16,12,16,16,60,100,2020
Switzerland,Switzerland,Free,1,1,12,15,12,39,15,12,15,15,57,96,2020
Syria,Syria,Not Free,7,7,0,0,0,-3,3,0,0,0,3,0,2020
Taiwan,Taiwan,Free,1,1,12,15,10,37,16,11,15,14,56,93,2020
Tajikistan,Tajikistan,Not Free,7,6,0,0,0,0,2,2,1,4,9,9,2020
Tanzania,Tanzania,Partly Free,5,5,6,6,5,17,7,4,5,7,23,40,2020
Thailand,Thailand,Partly Free,6,4,1,3,2,6,6,5,5,10,26,32,2020
Gambia,The Gambia,Partly Free,4,4,7,9,4,20,8,6,6,6,26,46,2020
Tibet,Tibet,Not Free,7,7,0,0,1,-2,0,0,0,3,3,1,2020
Timor-Leste,Timor-Leste,Free,2,3,11,14,7,32,14,8,8,9,39,71,2020
Togo,Togo,Partly Free,5,4,5,6,5,16,9,6,6,7,28,44,2020
Tonga,Tonga,Free,2,2,9,14,7,30,14,10,12,13,49,79,2020
Transnistria,Transnistria,Not Free,6,6,3,4,2,9,5,1,2,5,13,22,2020
Trinidad and Tobago,Trinidad and Tobago,Free,2,2,11,13,9,33,16,11,9,13,49,82,2020
Tunisia,Tunisia,Free,2,3,12,14,6,32,12,7,9,10,38,70,2020
Turkey,Turkey,Not Free,5,6,5,8,3,16,5,3,3,5,16,32,2020
Turkmenistan,Turkmenistan,Not Free,7,7,0,0,0,0,0,0,0,2,2,2,2020
Tuvalu,Tuvalu,Free,1,1,12,15,10,37,16,12,15,13,56,93,2020
Uganda,Uganda,Not Free,6,5,3,5,3,11,8,4,4,7,23,34,2020
Ukraine,Ukraine,Partly Free,3,3,9,12,6,27,11,7,7,10,35,62,2020
United Arab Emirates,United Arab Emirates,Not Free,7,6,1,2,2,5,3,2,3,4,12,17,2020
United Kingdom,United Kingdom,Free,1,1,12,16,11,39,14,12,14,15,55,94,2020
United States,United States,Free,2,1,10,14,9,33,16,11,11,15,53,86,2020
Uruguay,Uruguay,Free,1,1,12,16,12,40,16,12,15,15,58,98,2020
Uzbekistan,Uzbekistan,Not Free,7,6,1,0,1,2,2,1,1,4,8,10,2020
Vanuatu,Vanuatu,Free,2,2,10,15,8,33,14,11,13,11,49,82,2020
Venezuela,Venezuela,Not Free,7,6,0,2,0,2,6,2,1,5,14,16,2020
Vietnam,Vietnam,Not Free,7,5,0,1,2,3,4,1,4,8,17,20,2020
West Bank,West Bank,Not Free,7,5,1,4,2,4,7,5,4,5,21,25,2020
Western Sahara,Western Sahara,Not Free,7,7,0,0,0,-3,3,0,0,4,7,4,2020
Yemen,Yemen,Not Free,7,6,0,1,0,1,3,3,2,2,10,11,2020
Zambia,Zambia,Partly Free,4,4,6,10,6,22,9,7,8,8,32,54,2020
Zimbabwe,Zimbabwe,Partly Free,5,5,3,6,3,12,7,3,2,5,17,29,2020
Abkhazia,Abkhazia,Partly Free,4,5,6,8,4,18,8,6,4,5,23,41,2019
Afghanistan,Afghanistan,Not Free,5,6,3,7,3,13,6,4,2,2,14,27,2019
Albania,Albania,Partly Free,3,3,8,13,7,28,13,9,9,9,40,68,2019
Algeria,Algeria,Not Free,6,5,3,4,3,10,7,4,6,7,24,34,2019
Andorra,Andorra,Free,1,1,12,15,12,39,14,11,15,15,55,94,2019
Angola,Angola,Not Free,6,5,3,6,2,11,7,6,4,3,20,31,2019
Antigua and Barbuda,Antigua and Barbuda,Free,2,2,12,13,8,33,15,9,14,13,51,84,2019
Argentina,Argentina,Free,2,2,11,15,8,34,15,11,10,14,50,84,2019
Armenia,Armenia,Partly Free,4,4,6,10,4,20,9,7,6,9,31,51,2019
Australia,Australia,Free,1,1,12,16,12,40,16,12,15,15,58,98,2019
Austria,Austria,Free,1,1,12,15,10,37,14,12,15,15,56,93,2019
Azerbaijan,Azerbaijan,Not Free,7,6,0,2,0,2,2,1,1,5,9,11,2019
Bahamas,Bahamas,Free,1,1,12,16,10,38,15,12,13,13,53,91,2019
Bahrain,Bahrain,Not Free,7,6,2,0,3,2,2,1,1,6,10,12,2019
Bangladesh,Bangladesh,Partly Free,5,5,5,7,5,17,6,5,4,9,24,41,2019
Barbados,Barbados,Free,1,1,12,16,10,38,16,12,15,15,58,96,2019
Belarus,Belarus,Not Free,7,6,0,3,2,5,2,3,2,7,14,19,2019
Belgium,Belgium,Free,1,1,12,16,11,39,15,12,15,15,57,96,2019
Belize,Belize,Free,1,2,12,14,10,36,15,10,12,13,50,86,2019
Benin,Benin,Free,2,2,9,15,8,32,15,11,11,10,47,79,2019
Bhutan,Bhutan,Partly Free,3,4,10,11,9,29,9,5,8,8,30,59,2019
Bolivia,Bolivia,Partly Free,3,3,10,11,7,28,14,9,6,10,39,67,2019
Bosnia and Herzegovina,Bosnia and Herzegovina,Partly Free,4,4,6,9,4,19,10,7,7,10,34,53,2019
Botswana,Botswana,Free,3,2,10,10,8,28,12,10,11,11,44,72,2019
Brazil,Brazil,Free,2,2,10,14,6,30,15,9,8,13,45,75,2019
Brunei,Brunei,Not Free,6,5,0,3,4,7,6,3,6,7,22,29,2019
Bulgaria,Bulgaria,Free,2,2,11,14,8,33,14,11,10,12,47,80,2019
Burkina Faso,Burkina Faso,Partly Free,4,3,7,10,6,23,13,9,7,8,37,60,2019
Burundi,Burundi,Not Free,7,6,0,3,0,3,5,1,1,4,11,14,2019
Cape Verde,Cabo Verde,Free,1,1,12,15,10,37,15,11,14,13,53,90,2019
Cambodia,Cambodia,Not Free,6,5,1,2,3,6,8,3,3,6,20,26,2019
Cameroon,Cameroon,Not Free,6,6,1,3,3,7,5,2,1,4,12,19,2019
Canada,Canada,Free,1,1,12,16,12,40,16,12,15,16,59,99,2019
Central African Republic,Central African Republic,Not Free,7,7,3,2,0,4,4,1,0,0,5,9,2019
Chad,Chad,Not Free,7,6,1,1,1,3,6,4,1,3,14,17,2019
Chile,Chile,Free,1,1,12,15,10,37,16,12,14,15,57,94,2019
China,China,Not Free,7,6,0,0,2,-1,2,2,2,6,12,11,2019
Colombia,Colombia,Partly Free,3,3,10,11,8,29,12,6,9,10,37,66,2019
Comoros,Comoros,Partly Free,4,4,8,9,4,21,10,6,7,6,29,50,2019
Congo,Congo (Brazzaville),Not Free,7,5,0,2,0,2,7,5,1,6,19,21,2019
DR Congo,Congo (Kinshasa),Not Free,7,6,0,2,1,3,7,1,0,4,12,15,2019
Costa Rica,Costa Rica,Free,1,1,12,15,11,38,16,11,13,13,53,91,2019
Cote d'Ivoire,Cote d'Ivoire,Partly Free,4,4,7,8,4,19,11,8,6,7,32,51,2019
Crimea,Crimea,Not Free,7,6,0,0,0,-2,3,1,0,6,10,8,2019
Croatia,Croatia,Free,1,2,12,14,10,36,13,12,11,13,49,85,2019
Cuba,Cuba,Not Free,7,6,0,0,1,1,5,0,2,6,13,14,2019
Cyprus,Cyprus,Free,1,1,12,15,11,38,15,12,15,14,56,94,2019
Czech Republic,Czech Republic,Free,1,1,12,15,9,36,14,12,14,15,55,91,2019
Denmark,Denmark,Free,1,1,12,16,12,40,16,12,14,15,57,97,2019
Djibouti,Djibouti,Not Free,6,5,2,3,2,7,6,3,4,6,19,26,2019
Dominica,Dominica,Free,1,1,11,16,10,37,15,11,15,15,56,93,2019
Dominican Republic,Dominican Republic,Partly Free,3,3,9,10,7,26,14,10,8,9,41,67,2019
Ecuador,Ecuador,Partly Free,3,3,7,11,7,25,12,9,7,10,38,63,2019
Egypt,Egypt,Not Free,6,6,2,3,3,8,4,1,3,6,14,22,2019
El Salvador,El Salvador,Free,2,3,11,13,8,32,12,8,7,8,35,67,2019
Equatorial Guinea,Equatorial Guinea,Not Free,7,7,0,0,0,0,3,0,0,3,6,6,2019
Eritrea,Eritrea,Not Free,7,7,0,0,1,1,0,0,0,1,1,2,2019
Estonia,Estonia,Free,1,1,12,15,11,38,16,12,14,14,56,94,2019
Eswatini,Eswatini,Not Free,7,6,0,1,0,1,5,2,4,4,15,16,2019
Ethiopia,Ethiopia,Not Free,6,6,1,3,3,7,4,2,2,4,12,19,2019
Fiji,Fiji,Partly Free,3,3,8,9,7,24,12,8,7,10,37,61,2019
Finland,Finland,Free,1,1,12,16,12,40,16,12,16,16,60,100,2019
France,France,Free,1,2,12,15,11,38,14,11,13,14,52,90,2019
Gabon,Gabon,Not Free,7,5,0,2,2,4,8,3,3,5,19,23,2019
Gaza Strip,Gaza Strip,Not Free,7,6,0,2,1,3,4,2,0,2,8,11,2019
Georgia,Georgia,Partly Free,3,3,8,10,7,25,10,8,8,12,38,63,2019
Germany,Germany,Free,1,1,12,15,12,39,14,12,14,15,55,94,2019
Ghana,Ghana,Free,1,2,12,14,10,36,14,11,11,11,47,83,2019
Greece,Greece,Free,1,2,12,15,9,36,14,12,11,14,51,87,2019
Grenada,Grenada,Free,1,2,11,16,10,37,15,11,13,13,52,89,2019
Guatemala,Guatemala,Partly Free,4,4,8,10,4,22,11,6,6,8,31,53,2019
Guinea,Guinea,Partly Free,5,4,6,8,3,17,11,5,4,6,26,43,2019
Guinea-Bissau,Guinea-Bissau,Partly Free,5,4,6,8,1,15,11,7,4,5,27,42,2019
Guyana,Guyana,Free,2,3,11,13,8,32,15,11,8,9,43,75,2019
Haiti,Haiti,Partly Free,5,5,5,7,5,17,10,4,4,6,24,41,2019
Honduras,Honduras,Partly Free,4,4,7,8,5,20,9,4,5,8,26,46,2019
Hong Kong,Hong Kong,Partly Free,5,2,2,7,6,15,12,8,11,13,44,59,2019
Hungary,Hungary,Partly Free,3,3,9,11,7,27,10,10,10,13,43,70,2019
Iceland,Iceland,Free,1,1,12,15,10,37,15,12,15,15,57,94,2019
India,India,Free,2,3,12,14,9,35,11,10,9,10,40,75,2019
Indian Kashmir,Indian Kashmir,Partly Free,4,4,9,9,4,22,9,5,5,8,27,49,2019
Indonesia,Indonesia,Partly Free,2,4,11,13,6,30,11,7,5,9,32,62,2019
Iran,Iran,Not Free,6,6,3,2,2,7,3,1,3,4,11,18,2019
Iraq,Iraq,Not Free,5,6,8,8,2,17,5,5,1,4,15,32,2019
Ireland,Ireland,Free,1,1,12,16,11,39,16,12,14,16,58,97,2019
Israel,Israel,Free,2,3,12,13,10,35,12,9,11,11,43,78,2019
Italy,Italy,Free,1,1,12,14,10,36,15,12,12,14,53,89,2019
Jamaica,Jamaica,Free,2,2,12,13,9,34,15,10,8,11,44,78,2019
Japan,Japan,Free,1,1,12,16,12,40,15,12,15,14,56,96,2019
Jordan,Jordan,Partly Free,5,5,3,6,3,12,7,3,7,8,25,37,2019
Kazakhstan,Kazakhstan,Not Free,7,5,1,3,1,5,4,1,4,8,17,22,2019
Kenya,Kenya,Partly Free,4,4,6,8,5,19,10,7,5,7,29,48,2019
Kiribati,Kiribati,Free,1,1,12,15,10,37,16,12,15,13,56,93,2019
Kosovo,Kosovo,Partly Free,3,4,9,10,5,24,9,8,6,7,30,54,2019
Kuwait,Kuwait,Partly Free,5,5,2,7,4,13,6,4,7,6,23,36,2019
Kyrgyzstan,Kyrgyzstan,Partly Free,5,4,4,5,4,12,10,5,4,7,26,38,2019
Laos,Laos,Not Free,7,6,0,0,2,2,4,0,2,6,12,14,2019
Latvia,Latvia,Free,2,2,12,14,9,35,14,12,12,14,52,87,2019
Lebanon,Lebanon,Partly Free,5,4,5,7,2,14,11,8,5,7,31,45,2019
Lesotho,Lesotho,Partly Free,3,3,10,11,6,27,12,7,8,9,36,63,2019
Liberia,Liberia,Partly Free,3,3,8,12,7,27,11,8,7,9,35,62,2019
Libya,Libya,Not Free,7,6,0,1,0,1,4,2,0,2,8,9,2019
Liechtenstein,Liechtenstein,Free,2,1,10,13,10,33,16,12,14,15,57,90,2019
Lithuania,Lithuania,Free,1,1,12,16,10,38,16,11,12,14,53,91,2019
Luxembourg,Luxembourg,Free,1,1,12,16,10,38,16,12,16,16,60,98,2019
Madagascar,Madagascar,Partly Free,3,4,9,10,5,24,10,8,7,7,32,56,2019
Malawi,Malawi,Partly Free,3,3,8,12,6,26,14,8,9,7,38,64,2019
Malaysia,Malaysia,Partly Free,4,4,6,9,6,21,9,6,7,9,31,52,2019
Maldives,Maldives,Partly Free,5,5,5,6,3,14,3,6,5,7,21,35,2019
Mali,Mali,Partly Free,4,4,6,8,4,18,10,6,6,4,26,44,2019
Malta,Malta,Free,2,1,12,14,9,35,15,12,15,14,56,91,2019
Marshall Islands,Marshall Islands,Free,1,1,12,16,10,38,16,11,15,13,55,93,2019
Mauritania,Mauritania,Not Free,6,5,5,2,4,11,9,4,4,4,21,32,2019
Mauritius,Mauritius,Free,1,2,12,15,10,37,15,12,13,12,52,89,2019
Mexico,Mexico,Partly Free,3,3,9,13,5,27,13,7,6,10,36,63,2019
Micronesia,Micronesia,Free,1,1,12,15,10,37,16,11,15,13,55,92,2019
Moldova,Moldova,Partly Free,3,4,9,11,4,24,11,8,6,9,34,58,2019
Monaco,Monaco,Free,3,1,8,10,8,26,16,12,14,14,56,82,2019
Mongolia,Mongolia,Free,1,2,11,16,9,36,14,11,12,12,49,85,2019
Montenegro,Montenegro,Partly Free,4,3,8,9,6,23,11,9,10,12,42,65,2019
Morocco,Morocco,Partly Free,5,5,5,6,3,14,7,5,6,7,25,39,2019
Mozambique,Mozambique,Partly Free,4,4,5,9,5,19,9,7,7,9,32,51,2019
Myanmar,Myanmar,Partly Free,5,5,5,8,4,13,5,6,1,5,17,30,2019
Nagorno-Karabakh,Nagorno-Karabakh,Partly Free,5,5,4,5,3,12,6,4,4,5,19,31,2019
Namibia,Namibia,Free,3,2,10,11,8,29,14,11,11,10,46,75,2019
Nauru,Nauru,Free,2,2,12,14,8,34,13,9,10,12,44,78,2019
Nepal,Nepal,Partly Free,3,4,10,10,5,25,9,6,6,8,29,54,2019
Netherlands,Netherlands,Free,1,1,12,16,12,40,16,12,15,16,59,99,2019
New Zealand,New Zealand,Free,1,1,12,16,12,40,16,12,15,15,58,98,2019
Nicaragua,Nicaragua,Not Free,6,5,3,4,3,10,8,2,4,8,22,32,2019
Niger,Niger,Partly Free,4,4,6,8,6,20,11,6,6,6,29,49,2019
Nigeria,Nigeria,Partly Free,3,5,9,10,6,25,9,7,4,5,25,50,2019
North Korea,North Korea,Not Free,7,7,0,0,0,0,0,0,0,3,3,3,2019
Macedonia,North Macedonia,Partly Free,4,3,6,10,6,22,11,8,8,10,37,59,2019
Northern Cyprus,Northern Cyprus,Free,2,2,11,13,7,31,15,11,13,11,50,81,2019
Norway,Norway,Free,1,1,12,16,12,40,16,12,16,16,60,100,2019
Oman,Oman,Not Free,6,5,2,2,2,6,5,3,4,5,17,23,2019
Pakistan,Pakistan,Partly Free,5,5,5,7,5,17,6,6,4,6,22,39,2019
Pakistani Kashmir,Pakistani Kashmir,Not Free,6,5,4,4,3,9,6,4,3,6,19,28,2019
Palau,Palau,Free,1,1,12,15,10,37,16,11,15,13,55,92,2019
Panama,Panama,Free,1,2,12,15,9,36,15,11,10,12,48,84,2019
Papua New Guinea,Papua New Guinea,Partly Free,4,3,7,13,3,23,14,10,8,9,41,64,2019
Paraguay,Paraguay,Partly Free,3,3,10,12,6,28,12,8,7,10,37,65,2019
Peru,Peru,Free,2,3,11,13,7,31,15,8,8,11,42,73,2019
Philippines,Philippines,Partly Free,3,3,9,10,7,26,14,8,3,10,35,61,2019
Poland,Poland,Free,2,2,11,16,8,35,14,10,11,14,49,84,2019
Portugal,Portugal,Free,1,1,12,16,11,39,16,12,14,15,57,96,2019
Qatar,Qatar,Not Free,6,5,2,2,3,7,7,2,5,4,18,25,2019
Romania,Romania,Free,2,2,11,14,9,34,13,10,12,12,47,81,2019
Russia,Russia,Not Free,7,6,0,3,2,5,3,3,2,7,15,20,2019
Rwanda,Rwanda,Not Free,6,6,2,2,5,9,3,2,2,7,14,23,2019
Samoa,Samoa,Free,2,2,9,12,9,30,14,11,14,12,51,81,2019
San Marino,San Marino,Free,1,1,12,15,11,38,15,12,15,15,57,95,2019
Sao Tome and Principe,Sao Tome and Principe,Free,2,2,11,14,9,34,15,11,12,11,49,83,2019
Saudi Arabia,Saudi Arabia,Not Free,7,7,0,0,1,1,2,0,2,2,6,7,2019
Senegal,Senegal,Free,2,3,10,12,8,30,13,9,9,11,42,72,2019
Serbia,Serbia,Partly Free,3,3,8,10,6,24,12,10,9,12,43,67,2019
Seychelles,Seychelles,Partly Free,3,3,10,11,7,28,12,9,11,11,43,71,2019
Sierra Leone,Sierra Leone,Partly Free,3,3,10,11,7,28,12,6,9,10,37,65,2019
Singapore,Singapore,Partly Free,4,4,4,8,7,19,9,4,7,12,32,51,2019
Slovakia,Slovakia,Free,1,2,12,15,9,36,14,12,12,14,52,88,2019
Slovenia,Slovenia,Free,1,1,12,16,11,39,14,12,15,14,55,94,2019
Solomon Islands,Solomon Islands,Free,2,2,9,14,7,30,16,10,11,12,49,79,2019
Somalia,Somalia,Not Free,7,7,0,1,0,1,3,3,0,0,6,7,2019
Somaliland,Somaliland,Partly Free,4,5,5,10,4,19,6,5,7,6,24,43,2019
South Africa,South Africa,Free,2,2,12,13,8,33,15,12,9,10,46,79,2019
South Korea,South Korea,Free,2,2,11,13,9,33,14,11,12,13,50,83,2019
South Ossetia,South Ossetia,Not Free,7,6,2,2,0,2,3,1,1,3,8,10,2019
South Sudan,South Sudan,Not Free,7,7,1,1,0,-2,2,2,0,0,4,2,2019
Spain,Spain,Free,1,1,12,16,11,39,14,11,15,15,55,94,2019
Sri Lanka,Sri Lanka,Partly Free,3,4,9,10,6,24,8,8,8,8,32,56,2019
St. Kitts and Nevis,St. Kitts and Nevis,Free,1,1,10,16,10,36,15,12,13,13,53,89,2019
St. Lucia,St. Lucia,Free,1,1,11,16,11,38,15,12,13,14,54,92,2019
St. Vincent and the Grenadines,St. Vincent and the Grenadines,Free,1,1,11,15,10,36,15,12,14,14,55,91,2019
Sudan,Sudan,Not Free,7,7,2,3,1,3,2,1,0,1,4,7,2019
Suriname,Suriname,Free,2,3,12,14,8,34,14,11,8,10,43,77,2019
Sweden,Sweden,Free,1,1,12,16,12,40,16,12,16,16,60,100,2019
Switzerland,Switzerland,Free,1,1,12,15,12,39,15,12,15,15,57,96,2019
Syria,Syria,Not Free,7,7,0,0,0,-3,3,0,0,0,3,0,2019
Taiwan,Taiwan,Free,1,1,12,15,10,37,16,11,15,14,56,93,2019
Tajikistan,Tajikistan,Not Free,7,6,0,0,0,0,2,2,1,4,9,9,2019
Tanzania,Tanzania,Partly Free,4,5,7,7,6,20,7,5,6,7,25,45,2019
Thailand,Thailand,Not Free,7,5,0,3,2,5,6,4,5,10,25,30,2019
Gambia,The Gambia,Partly Free,4,5,7,9,4,20,8,6,5,6,25,45,2019
Tibet,Tibet,Not Free,7,7,0,0,1,-2,0,0,0,3,3,1,2019
Timor-Leste,Timor-Leste,Free,2,3,11,14,7,32,14,8,7,9,38,70,2019
Togo,Togo,Partly Free,5,4,4,6,5,15,9,6,6,7,28,43,2019
Tonga,Tonga,Free,2,2,9,14,7,30,14,10,12,13,49,79,2019
Transnistria,Transnistria,Not Free,6,6,3,5,2,10,5,2,2,5,14,24,2019
Trinidad and Tobago,Trinidad and Tobago,Free,2,2,11,13,9,33,16,11,9,13,49,82,2019
Tunisia,Tunisia,Free,2,3,11,14,6,31,12,7,9,10,38,69,2019
Turkey,Turkey,Not Free,5,6,5,7,3,15,5,3,3,5,16,31,2019
Turkmenistan,Turkmenistan,Not Free,7,7,0,0,0,0,0,0,0,2,2,2,2019
Tuvalu,Tuvalu,Free,1,1,12,15,10,37,16,12,15,13,56,93,2019
Uganda,Uganda,Not Free,6,5,3,5,3,11,10,4,4,7,25,36,2019
Ukraine,Ukraine,Partly Free,3,4,9,11,6,26,11,7,6,10,34,60,2019
United Arab Emirates,United Arab Emirates,Not Free,7,6,1,2,2,5,3,2,3,4,12,17,2019
United Kingdom,United Kingdom,Free,1,1,12,16,11,39,14,12,14,14,54,93,2019
United States,United States,Free,2,1,10,14,9,33,16,11,11,15,53,86,2019
Uruguay,Uruguay,Free,1,1,12,16,12,40,16,12,15,15,58,98,2019
Uzbekistan,Uzbekistan,Not Free,7,6,0,0,1,1,2,1,1,4,8,9,2019
Vanuatu,Vanuatu,Free,2,2,10,15,8,33,15,11,12,11,49,82,2019
Venezuela,Venezuela,Not Free,7,6,0,3,0,3,7,2,1,6,16,19,2019
Vietnam,Vietnam,Not Free,7,5,0,1,2,3,4,1,4,8,17,20,2019
West Bank,West Bank,Not Free,7,5,1,4,2,4,7,5,4,5,21,25,2019
Western Sahara,Western Sahara,Not Free,7,7,0,0,0,-3,3,0,0,4,7,4,2019
Yemen,Yemen,Not Free,7,6,0,1,0,1,3,3,2,2,10,11,2019
Zambia,Zambia,Partly Free,4,4,6,10,6,22,9,7,8,8,32,54,2019
Zimbabwe,Zimbabwe,Partly Free,5,5,3,6,3,12,8,4,2,5,19,31,2019
Abkhazia,Abkhazia,Partly Free,4,5,6,8,4,18,8,6,4,5,23,41,2018
Afghanistan,Afghanistan,Not Free,5,6,2,7,3,12,6,4,2,2,14,26,2018
Albania,Albania,Partly Free,3,3,8,13,7,28,13,9,9,9,40,68,2018
Algeria,Algeria,Not Free,6,5,3,4,3,10,7,5,6,7,25,35,2018
Andorra,Andorra,Free,1,1,12,15,12,39,15,11,15,16,57,96,2018
Angola,Angola,Not Free,6,6,3,6,1,10,7,3,3,3,16,26,2018
Antigua and Barbuda,Antigua and Barbuda,Free,2,2,12,13,8,33,15,9,13,13,50,83,2018
Argentina,Argentina,Free,2,2,11,14,8,33,15,11,10,14,50,83,2018
Armenia,Armenia,Partly Free,5,4,4,7,4,15,9,6,6,9,30,45,2018
Australia,Australia,Free,1,1,12,16,12,40,16,12,15,15,58,98,2018
Austria,Austria,Free,1,1,12,15,10,37,15,12,15,15,57,94,2018
Azerbaijan,Azerbaijan,Not Free,7,6,1,2,0,3,2,1,1,5,9,12,2018
Bahamas,Bahamas,Free,1,1,12,16,10,38,15,12,13,13,53,91,2018
Bahrain,Bahrain,Not Free,7,6,2,0,3,2,2,1,1,6,10,12,2018
Bangladesh,Bangladesh,Partly Free,4,4,7,7,5,19,7,5,5,9,26,45,2018
Barbados,Barbados,Free,1,1,12,16,10,38,16,12,15,15,58,96,2018
Belarus,Belarus,Not Free,6,6,0,4,2,6,3,3,2,7,15,21,2018
Belgium,Belgium,Free,1,1,12,16,11,39,15,12,14,15,56,95,2018
Belize,Belize,Free,1,2,12,14,10,36,15,10,12,13,50,86,2018
Benin,Benin,Free,2,2,9,16,8,33,15,12,12,10,49,82,2018
Bhutan,Bhutan,Partly Free,3,4,10,10,9,28,9,4,6,8,27,55,2018
Bolivia,Bolivia,Partly Free,3,3,10,11,7,28,14,9,6,10,39,67,2018
Bosnia and Herzegovina,Bosnia and Herzegovina,Partly Free,4,4,7,10,4,21,10,7,7,10,34,55,2018
Botswana,Botswana,Free,3,2,10,10,8,28,12,10,11,11,44,72,2018
Brazil,Brazil,Free,2,2,11,14,6,31,15,10,9,13,47,78,2018
Brunei,Brunei,Not Free,6,5,0,3,3,6,6,3,6,7,22,28,2018
Bulgaria,Bulgaria,Free,2,2,11,14,8,33,14,11,10,12,47,80,2018
Burkina Faso,Burkina Faso,Partly Free,4,3,7,10,6,23,13,9,7,8,37,60,2018
Burundi,Burundi,Not Free,7,6,1,3,0,4,6,2,1,5,14,18,2018
Cape Verde,Cabo Verde,Free,1,1,12,15,10,37,15,11,14,13,53,90,2018
Cambodia,Cambodia,Not Free,6,5,4,3,3,10,8,3,3,6,20,30,2018
Cameroon,Cameroon,Not Free,6,6,3,3,3,9,6,2,1,4,13,22,2018
Canada,Canada,Free,1,1,12,16,12,40,16,12,15,16,59,99,2018
Central African Republic,Central African Republic,Not Free,7,7,3,2,0,4,4,1,0,0,5,9,2018
Chad,Chad,Not Free,7,6,2,1,1,4,6,4,1,3,14,18,2018
Chile,Chile,Free,1,1,12,15,10,37,16,12,14,15,57,94,2018
China,China,Not Free,7,6,0,0,2,0,3,3,2,6,14,14,2018
Colombia,Colombia,Partly Free,3,3,10,11,8,29,12,5,9,10,36,65,2018
Comoros,Comoros,Partly Free,3,4,9,11,4,24,10,7,8,6,31,55,2018
Congo,Congo (Brazzaville),Not Free,7,5,0,2,0,2,7,5,1,6,19,21,2018
DR Congo,Congo (Kinshasa),Not Free,7,6,0,3,1,4,7,2,0,4,13,17,2018
Costa Rica,Costa Rica,Free,1,1,12,15,11,38,16,11,13,13,53,91,2018
Cote d'Ivoire,Cote d'Ivoire,Partly Free,4,4,7,8,4,19,11,8,6,7,32,51,2018
Crimea,Crimea,Not Free,7,6,0,0,0,-1,3,1,0,6,10,9,2018
Croatia,Croatia,Free,1,2,12,15,10,37,13,12,11,13,49,86,2018
Cuba,Cuba,Not Free,7,6,0,0,1,1,5,0,2,6,13,14,2018
Cyprus,Cyprus,Free,1,1,11,16,11,38,15,12,15,14,56,94,2018
Czech Republic,Czech Republic,Free,1,1,12,15,10,37,15,12,14,15,56,93,2018
Denmark,Denmark,Free,1,1,12,16,12,40,16,12,14,15,57,97,2018
Djibouti,Djibouti,Not Free,6,5,2,3,2,7,6,3,4,6,19,26,2018
Dominica,Dominica,Free,1,1,11,16,10,37,15,11,15,15,56,93,2018
Dominican Republic,Dominican Republic,Partly Free,3,3,9,10,7,26,14,10,8,9,41,67,2018
Ecuador,Ecuador,Partly Free,3,3,7,11,7,25,12,7,6,10,35,60,2018
Egypt,Egypt,Not Free,6,6,3,4,3,10,5,2,3,6,16,26,2018
El Salvador,El Salvador,Free,2,3,11,14,9,34,12,8,8,8,36,70,2018
Equatorial Guinea,Equatorial Guinea,Not Free,7,7,0,1,0,1,3,0,0,3,6,7,2018
Eritrea,Eritrea,Not Free,7,7,0,0,1,1,0,0,0,2,2,3,2018
Estonia,Estonia,Free,1,1,12,15,11,38,16,12,14,14,56,94,2018
Eswatini,Eswatini,Not Free,7,6,0,1,0,1,5,2,4,4,15,16,2018
Ethiopia,Ethiopia,Not Free,7,6,1,0,3,4,2,0,2,4,8,12,2018
Fiji,Fiji,Partly Free,3,3,8,9,7,24,12,6,7,10,35,59,2018
Finland,Finland,Free,1,1,12,16,12,40,16,12,16,16,60,100,2018
France,France,Free,1,2,12,15,11,38,14,11,13,14,52,90,2018
Gabon,Gabon,Not Free,7,5,0,2,2,4,8,3,3,5,19,23,2018
Gaza Strip,Gaza Strip,Not Free,7,6,0,2,1,3,4,3,0,2,9,12,2018
Georgia,Georgia,Partly Free,3,3,9,10,7,26,11,8,8,11,38,64,2018
Germany,Germany,Free,1,1,12,15,12,39,14,12,14,15,55,94,2018
Ghana,Ghana,Free,1,2,12,15,10,37,14,11,11,10,46,83,2018
Greece,Greece,Free,2,2,12,15,8,35,14,12,11,13,50,85,2018
Grenada,Grenada,Free,1,2,11,16,10,37,15,11,12,13,51,88,2018
Guatemala,Guatemala,Partly Free,4,4,8,10,5,23,12,6,7,8,33,56,2018
Guinea,Guinea,Partly Free,5,5,6,8,3,17,10,5,4,5,24,41,2018
Guinea-Bissau,Guinea-Bissau,Partly Free,5,5,7,8,1,16,10,6,4,5,25,41,2018
Guyana,Guyana,Free,2,3,11,13,8,32,15,10,8,9,42,74,2018
Haiti,Haiti,Partly Free,5,5,5,7,5,17,10,4,4,6,24,41,2018
Honduras,Honduras,Partly Free,4,4,7,8,5,20,9,4,5,8,26,46,2018
Hong Kong,Hong Kong,Partly Free,5,2,2,7,6,15,12,8,11,13,44,59,2018
Hungary,Hungary,Free,3,2,9,12,7,28,11,10,10,13,44,72,2018
Iceland,Iceland,Free,1,1,12,15,10,37,15,12,15,16,58,95,2018
India,India,Free,2,3,12,14,9,35,13,10,9,10,42,77,2018
Indian Kashmir,Indian Kashmir,Partly Free,4,4,9,9,4,22,9,5,5,8,27,49,2018
Indonesia,Indonesia,Partly Free,2,4,11,13,6,30,12,8,5,9,34,64,2018
Iran,Iran,Not Free,6,6,3,2,2,7,3,1,3,4,11,18,2018
Iraq,Iraq,Not Free,5,6,8,7,2,16,5,6,0,4,15,31,2018
Ireland,Ireland,Free,1,1,12,16,11,39,16,12,14,15,57,96,2018
Israel,Israel,Free,1,3,12,14,10,36,12,9,11,11,43,79,2018
Italy,Italy,Free,1,1,12,14,10,36,15,12,12,14,53,89,2018
Jamaica,Jamaica,Free,2,3,12,13,9,34,15,9,8,11,43,77,2018
Japan,Japan,Free,1,1,12,16,12,40,15,12,15,14,56,96,2018
Jordan,Jordan,Partly Free,5,5,3,6,3,12,7,3,7,8,25,37,2018
Kazakhstan,Kazakhstan,Not Free,7,5,1,3,1,5,4,1,4,8,17,22,2018
Kenya,Kenya,Partly Free,4,4,6,8,5,19,10,7,5,7,29,48,2018
Kiribati,Kiribati,Free,1,1,12,16,10,38,15,12,15,13,55,93,2018
Kosovo,Kosovo,Partly Free,3,4,9,10,5,24,9,6,6,7,28,52,2018
Kuwait,Kuwait,Partly Free,5,5,2,7,4,13,6,4,7,6,23,36,2018
Kyrgyzstan,Kyrgyzstan,Partly Free,5,5,4,5,4,12,10,4,4,7,25,37,2018
Laos,Laos,Not Free,7,6,0,0,1,1,4,0,2,5,11,12,2018
Latvia,Latvia,Free,2,2,12,14,9,35,15,12,12,13,52,87,2018
Lebanon,Lebanon,Partly Free,6,4,3,7,1,11,12,8,5,7,32,43,2018
Lesotho,Lesotho,Partly Free,3,3,10,11,6,27,12,7,9,9,37,64,2018
Liberia,Liberia,Partly Free,3,3,8,12,7,27,11,8,7,9,35,62,2018
Libya,Libya,Not Free,7,6,0,1,0,1,4,2,0,2,8,9,2018
Liechtenstein,Liechtenstein,Free,2,1,10,13,10,33,16,12,14,15,57,90,2018
Lithuania,Lithuania,Free,1,1,12,16,10,38,16,11,12,14,53,91,2018
Luxembourg,Luxembourg,Free,1,1,12,16,10,38,16,12,16,16,60,98,2018
Madagascar,Madagascar,Partly Free,3,4,9,10,5,24,10,8,6,8,32,56,2018
Malawi,Malawi,Partly Free,3,3,8,12,6,26,13,8,9,7,37,63,2018
Malaysia,Malaysia,Partly Free,4,4,6,7,5,18,7,6,5,9,27,45,2018
Maldives,Maldives,Partly Free,5,5,5,5,4,14,3,5,6,7,21,35,2018
Mali,Mali,Partly Free,5,4,6,7,4,17,11,6,6,4,27,44,2018
Malta,Malta,Free,1,1,12,14,10,36,15,12,15,14,56,92,2018
Marshall Islands,Marshall Islands,Free,1,1,12,15,10,37,16,11,15,13,55,92,2018
Mauritania,Mauritania,Not Free,6,5,3,2,4,9,9,4,4,4,21,30,2018
Mauritius,Mauritius,Free,1,2,12,15,10,37,15,12,13,12,52,89,2018
Mexico,Mexico,Partly Free,3,3,9,12,5,26,13,7,6,10,36,62,2018
Micronesia,Micronesia,Free,1,1,12,15,10,37,16,11,15,14,56,93,2018
Moldova,Moldova,Partly Free,3,3,10,11,5,26,12,8,6,9,35,61,2018
Monaco,Monaco,Free,3,1,7,10,8,25,16,12,15,14,57,82,2018
Mongolia,Mongolia,Free,1,2,11,16,9,36,14,11,12,12,49,85,2018
Montenegro,Montenegro,Partly Free,3,3,8,10,7,25,11,9,10,12,42,67,2018
Morocco,Morocco,Partly Free,5,5,5,6,3,14,7,5,6,7,25,39,2018
Mozambique,Mozambique,Partly Free,4,4,6,9,5,20,9,7,7,9,32,52,2018
Myanmar,Myanmar,Partly Free,5,5,5,8,4,13,6,6,1,5,18,31,2018
Nagorno-Karabakh,Nagorno-Karabakh,Partly Free,5,5,4,5,3,12,6,3,4,5,18,30,2018
Namibia,Namibia,Free,2,2,10,11,9,30,14,12,11,10,47,77,2018
Nauru,Nauru,Free,2,2,12,15,8,35,13,9,10,14,46,81,2018
Nepal,Nepal,Partly Free,3,4,10,10,5,25,10,6,6,8,30,55,2018
Netherlands,Netherlands,Free,1,1,12,16,12,40,16,12,15,16,59,99,2018
New Zealand,New Zealand,Free,1,1,12,16,12,40,16,12,15,15,58,98,2018
Nicaragua,Nicaragua,Partly Free,5,4,3,6,3,12,11,5,6,10,32,44,2018
Niger,Niger,Partly Free,4,4,6,8,6,20,11,6,6,6,29,49,2018
Nigeria,Nigeria,Partly Free,3,5,9,10,6,25,9,7,4,5,25,50,2018
North Korea,North Korea,Not Free,7,7,0,0,0,0,0,0,0,3,3,3,2018
Macedonia,North Macedonia,Partly Free,4,3,6,9,6,21,11,8,8,10,37,58,2018
Northern Cyprus,Northern Cyprus,Free,2,2,11,13,7,31,15,11,13,11,50,81,2018
Norway,Norway,Free,1,1,12,16,12,40,16,12,16,16,60,100,2018
Oman,Oman,Not Free,6,5,2,2,2,6,5,3,4,5,17,23,2018
Pakistan,Pakistan,Partly Free,4,5,6,8,5,19,7,6,5,6,24,43,2018
Pakistani Kashmir,Pakistani Kashmir,Not Free,6,5,4,4,3,9,6,4,3,6,19,28,2018
Palau,Palau,Free,1,1,12,15,10,37,16,11,15,13,55,92,2018
Panama,Panama,Free,2,2,12,15,8,35,15,11,10,12,48,83,2018
Papua New Guinea,Papua New Guinea,Partly Free,3,3,8,13,4,25,13,9,7,9,38,63,2018
Paraguay,Paraguay,Partly Free,3,3,10,12,5,27,12,8,7,10,37,64,2018
Peru,Peru,Free,2,3,11,13,7,31,15,8,8,11,42,73,2018
Philippines,Philippines,Partly Free,3,3,9,11,7,27,14,8,3,10,35,62,2018
Poland,Poland,Free,1,2,12,16,8,36,14,10,11,14,49,85,2018
Portugal,Portugal,Free,1,1,12,16,11,39,16,12,15,15,58,97,2018
Qatar,Qatar,Not Free,6,5,2,2,3,7,7,2,4,4,17,24,2018
Romania,Romania,Free,2,2,11,14,10,35,14,11,12,12,49,84,2018
Russia,Russia,Not Free,7,6,0,3,2,5,3,3,2,7,15,20,2018
Rwanda,Rwanda,Not Free,6,6,2,1,5,8,4,2,2,7,15,23,2018
Samoa,Samoa,Free,2,2,9,12,9,30,14,10,14,12,50,80,2018
San Marino,San Marino,Free,1,1,12,15,11,38,15,12,16,16,59,97,2018
Sao Tome and Principe,Sao Tome and Principe,Free,2,2,11,14,9,34,15,10,12,11,48,82,2018
Saudi Arabia,Saudi Arabia,Not Free,7,7,0,0,1,0,3,0,2,2,7,7,2018
Senegal,Senegal,Free,2,2,10,13,8,31,13,10,10,11,44,75,2018
Serbia,Serbia,Free,3,2,9,12,7,28,13,10,9,13,45,73,2018
Seychelles,Seychelles,Partly Free,3,3,10,11,7,28,12,9,11,11,43,71,2018
Sierra Leone,Sierra Leone,Partly Free,3,3,10,11,7,28,12,7,9,10,38,66,2018
Singapore,Singapore,Partly Free,4,4,4,8,7,19,10,4,7,12,33,52,2018
Slovakia,Slovakia,Free,1,1,12,15,9,36,15,12,12,14,53,89,2018
Slovenia,Slovenia,Free,1,1,12,16,11,39,14,12,14,14,54,93,2018
Solomon Islands,Solomon Islands,Free,3,2,9,13,6,28,14,9,9,12,44,72,2018
Somalia,Somalia,Not Free,7,7,0,1,0,1,3,2,0,1,6,7,2018
Somaliland,Somaliland,Partly Free,4,5,5,10,4,19,7,5,7,6,25,44,2018
South Africa,South Africa,Free,2,2,12,13,7,32,15,12,9,10,46,78,2018
South Korea,South Korea,Free,2,2,11,13,9,33,14,11,13,13,51,84,2018
South Ossetia,South Ossetia,Not Free,7,6,2,2,0,2,3,1,1,3,8,10,2018
South Sudan,South Sudan,Not Free,7,7,1,1,0,-2,2,2,0,0,4,2,2018
Spain,Spain,Free,1,1,11,16,11,38,15,11,15,15,56,94,2018
Sri Lanka,Sri Lanka,Partly Free,3,4,8,10,7,24,8,8,7,8,31,55,2018
St. Kitts and Nevis,St. Kitts and Nevis,Free,1,1,10,16,10,36,15,12,13,13,53,89,2018
St. Lucia,St. Lucia,Free,1,1,11,16,11,38,15,12,12,14,53,91,2018
St. Vincent and the Grenadines,St. Vincent and the Grenadines,Free,1,1,11,15,10,36,15,12,13,14,54,90,2018
Sudan,Sudan,Not Free,7,7,2,4,1,4,2,1,0,1,4,8,2018
Suriname,Suriname,Free,2,2,12,14,8,34,15,11,8,10,44,78,2018
Sweden,Sweden,Free,1,1,12,16,12,40,16,12,16,16,60,100,2018
Switzerland,Switzerland,Free,1,1,12,15,12,39,15,12,15,15,57,96,2018
Syria,Syria,Not Free,7,7,0,0,0,-3,2,0,0,0,2,-1,2018
Taiwan,Taiwan,Free,1,1,12,15,10,37,16,11,15,14,56,93,2018
Tajikistan,Tajikistan,Not Free,7,6,0,0,1,1,2,2,2,4,10,11,2018
Tanzania,Tanzania,Partly Free,4,4,7,9,6,22,7,6,8,9,30,52,2018
Thailand,Thailand,Not Free,6,5,0,3,3,6,6,4,5,10,25,31,2018
Gambia,The Gambia,Partly Free,4,5,7,9,4,20,7,5,3,6,21,41,2018
Tibet,Tibet,Not Free,7,7,0,0,1,-2,0,0,0,3,3,1,2018
Timor-Leste,Timor-Leste,Free,2,3,11,14,7,32,13,8,7,9,37,69,2018
Togo,Togo,Partly Free,4,4,6,7,5,18,9,6,7,7,29,47,2018
Tonga,Tonga,Free,2,2,9,14,7,30,12,9,12,12,45,75,2018
Transnistria,Transnistria,Not Free,6,6,3,5,2,10,5,2,2,5,14,24,2018
Trinidad and Tobago,Trinidad and Tobago,Free,2,2,11,13,9,33,15,11,9,13,48,81,2018
Tunisia,Tunisia,Free,2,3,10,14,6,30,12,9,9,10,40,70,2018
Turkey,Turkey,Not Free,5,6,6,7,3,16,5,3,2,6,16,32,2018
Turkmenistan,Turkmenistan,Not Free,7,7,0,0,0,0,1,0,0,3,4,4,2018
Tuvalu,Tuvalu,Free,1,1,12,15,10,37,16,12,15,14,57,94,2018
Uganda,Uganda,Partly Free,6,4,3,5,3,11,11,4,4,7,26,37,2018
Ukraine,Ukraine,Partly Free,3,3,9,11,6,26,11,9,6,10,36,62,2018
United Arab Emirates,United Arab Emirates,Not Free,7,6,1,2,2,5,3,2,3,4,12,17,2018
United Kingdom,United Kingdom,Free,1,1,12,16,12,40,14,12,14,14,54,94,2018
United States,United States,Free,2,1,10,14,9,33,16,10,12,15,53,86,2018
Uruguay,Uruguay,Free,1,1,12,16,12,40,16,12,15,15,58,98,2018
Uzbekistan,Uzbekistan,Not Free,7,7,0,0,1,1,1,1,0,4,6,7,2018
Vanuatu,Vanuatu,Free,2,2,10,15,8,33,15,11,11,11,48,81,2018
Venezuela,Venezuela,Not Free,6,5,2,6,0,8,8,2,1,7,18,26,2018
Vietnam,Vietnam,Not Free,7,5,0,1,2,3,4,1,4,8,17,20,2018
West Bank,West Bank,Not Free,7,5,2,4,2,5,8,5,5,5,23,28,2018
Western Sahara,Western Sahara,Not Free,7,7,0,0,0,-3,3,0,0,4,7,4,2018
Yemen,Yemen,Not Free,7,6,0,1,0,1,5,3,2,2,12,13,2018
Zambia,Zambia,Partly Free,4,4,6,10,6,22,10,7,8,8,33,55,2018
Zimbabwe,Zimbabwe,Not Free,6,5,2,6,2,10,8,4,3,5,20,30,2018
Abkhazia,Abkhazia,Partly Free,4,5,6,8,4,18,8,6,4,5,23,41,2017
Afghanistan,Afghanistan,Not Free,6,6,2,6,2,10,6,4,2,2,14,24,2017
Albania,Albania,Partly Free,3,3,8,13,7,28,13,9,9,9,40,68,2017
Algeria,Algeria,Not Free,6,5,4,4,3,11,7,5,5,7,24,35,2017
Andorra,Andorra,Free,1,1,12,15,12,39,15,11,15,15,56,95,2017
Angola,Angola,Not Free,6,6,3,6,1,10,5,3,3,3,14,24,2017
Antigua and Barbuda,Antigua and Barbuda,Free,2,2,12,13,8,33,15,9,13,13,50,83,2017
Argentina,Argentina,Free,2,2,11,14,8,33,14,11,10,14,49,82,2017
Armenia,Armenia,Partly Free,5,4,5,7,4,16,9,6,5,9,29,45,2017
Australia,Australia,Free,1,1,12,16,12,40,16,12,15,15,58,98,2017
Austria,Austria,Free,1,1,12,15,10,37,16,12,15,15,58,95,2017
Azerbaijan,Azerbaijan,Not Free,7,6,1,2,1,4,2,1,2,5,10,14,2017
Bahamas,Bahamas,Free,1,1,12,16,10,38,15,12,13,13,53,91,2017
Bahrain,Bahrain,Not Free,7,6,2,0,3,2,2,1,1,6,10,12,2017
Bangladesh,Bangladesh,Partly Free,4,4,7,8,5,20,7,6,5,9,27,47,2017
Barbados,Barbados,Free,1,1,12,16,12,40,16,12,15,15,58,98,2017
Belarus,Belarus,Not Free,7,6,0,4,1,5,3,3,2,7,15,20,2017
Belgium,Belgium,Free,1,1,12,16,12,40,15,12,13,15,55,95,2017
Belize,Belize,Free,1,2,12,14,10,36,15,11,12,13,51,87,2017
Benin,Benin,Free,2,2,9,16,8,33,15,12,12,10,49,82,2017
Bhutan,Bhutan,Partly Free,3,4,10,10,9,28,9,4,6,8,27,55,2017
Bolivia,Bolivia,Partly Free,3,3,11,11,7,29,14,9,6,10,39,68,2017
Bosnia and Herzegovina,Bosnia and Herzegovina,Partly Free,4,4,7,10,4,21,10,7,7,10,34,55,2017
Botswana,Botswana,Free,3,2,10,10,8,28,12,10,11,11,44,72,2017
Brazil,Brazil,Free,2,2,11,14,6,31,15,10,10,13,48,79,2017
Brunei,Brunei,Not Free,6,5,0,3,3,7,6,3,6,7,22,29,2017
Bulgaria,Bulgaria,Free,2,2,11,14,8,33,14,11,10,12,47,80,2017
Burkina Faso,Burkina Faso,Partly Free,4,3,7,10,6,23,14,9,8,9,40,63,2017
Burundi,Burundi,Not Free,7,6,1,4,0,5,6,2,1,5,14,19,2017
Cape Verde,Cabo Verde,Free,1,1,12,15,10,37,15,11,14,13,53,90,2017
Cambodia,Cambodia,Not Free,6,5,4,4,3,11,8,3,3,6,20,31,2017
Cameroon,Cameroon,Not Free,6,6,3,3,3,9,7,3,1,4,15,24,2017
Canada,Canada,Free,1,1,12,16,12,40,16,12,15,16,59,99,2017
Central African Republic,Central African Republic,Not Free,7,7,3,2,0,4,4,1,0,1,6,10,2017
Chad,Chad,Not Free,7,6,2,1,1,4,6,4,1,3,14,18,2017
Chile,Chile,Free,1,1,12,15,10,37,16,12,14,15,57,94,2017
China,China,Not Free,7,6,0,1,2,1,3,3,2,6,14,15,2017
Colombia,Colombia,Partly Free,3,3,10,11,8,29,12,5,8,10,35,64,2017
Comoros,Comoros,Partly Free,3,4,9,11,4,24,10,7,8,6,31,55,2017
Congo,Congo (Brazzaville),Not Free,7,5,1,2,2,5,7,6,2,7,22,27,2017
DR Congo,Congo (Kinshasa),Not Free,7,6,0,3,1,4,8,3,0,4,15,19,2017
Costa Rica,Costa Rica,Free,1,1,12,15,11,38,16,11,13,13,53,91,2017
Cote d'Ivoire,Cote d'Ivoire,Partly Free,4,4,7,8,5,20,11,8,6,7,32,52,2017
Crimea,Crimea,Not Free,7,6,0,0,0,-1,3,1,0,6,10,9,2017
Croatia,Croatia,Free,1,2,12,15,10,37,14,12,11,13,50,87,2017
Cuba,Cuba,Not Free,7,6,0,0,1,1,5,0,3,6,14,15,2017
Cyprus,Cyprus,Free,1,1,11,16,11,38,15,12,15,14,56,94,2017
Czech Republic,Czech Republic,Free,1,1,12,15,11,38,15,12,14,15,56,94,2017
Denmark,Denmark,Free,1,1,12,16,12,40,16,12,14,15,57,97,2017
Djibouti,Djibouti,Not Free,6,5,2,3,2,7,6,3,4,6,19,26,2017
Dominica,Dominica,Free,1,1,12,16,10,38,15,12,15,15,57,95,2017
Dominican Republic,Dominican Republic,Partly Free,3,3,9,10,8,27,14,10,8,9,41,68,2017
Ecuador,Ecuador,Partly Free,3,4,7,11,6,24,11,6,6,10,33,57,2017
Egypt,Egypt,Not Free,6,5,3,4,2,9,5,4,2,6,17,26,2017
El Salvador,El Salvador,Free,2,3,11,14,9,34,12,8,8,8,36,70,2017
Equatorial Guinea,Equatorial Guinea,Not Free,7,7,0,1,0,1,4,0,0,3,7,8,2017
Eritrea,Eritrea,Not Free,7,7,0,0,1,1,0,0,0,2,2,3,2017
Estonia,Estonia,Free,1,1,12,15,11,38,16,12,14,14,56,94,2017
Eswatini,Eswatini,Not Free,7,5,0,1,0,1,7,2,4,4,17,18,2017
Ethiopia,Ethiopia,Not Free,7,6,1,0,3,4,2,0,2,4,8,12,2017
Fiji,Fiji,Partly Free,3,4,8,10,7,25,12,5,7,10,34,59,2017
Finland,Finland,Free,1,1,12,16,12,40,16,12,16,16,60,100,2017
France,France,Free,1,2,12,15,11,38,14,11,13,14,52,90,2017
Gabon,Gabon,Not Free,6,5,2,3,3,8,9,4,6,5,24,32,2017
Gaza Strip,Gaza Strip,Not Free,7,6,0,2,1,3,4,3,0,2,9,12,2017
Georgia,Georgia,Partly Free,3,3,9,11,7,27,11,8,8,10,37,64,2017
Germany,Germany,Free,1,1,12,15,12,39,15,12,14,15,56,95,2017
Ghana,Ghana,Free,1,2,12,15,10,37,14,11,11,10,46,83,2017
Greece,Greece,Free,2,2,12,15,8,35,14,11,11,13,49,84,2017
Grenada,Grenada,Free,1,2,12,16,10,38,15,11,12,13,51,89,2017
Guatemala,Guatemala,Partly Free,4,4,8,10,5,23,11,6,6,8,31,54,2017
Guinea,Guinea,Partly Free,5,5,6,8,3,17,10,5,4,5,24,41,2017
Guinea-Bissau,Guinea-Bissau,Partly Free,5,5,7,8,1,16,10,5,4,5,24,40,2017
Guyana,Guyana,Free,2,3,11,13,8,32,15,10,8,9,42,74,2017
Haiti,Haiti,Partly Free,5,5,3,8,4,15,10,4,4,6,24,39,2017
Honduras,Honduras,Partly Free,4,4,7,8,4,19,9,5,5,8,27,46,2017
Hong Kong,Hong Kong,Partly Free,5,2,3,7,6,16,12,8,12,13,45,61,2017
Hungary,Hungary,Free,3,2,9,13,7,29,13,11,10,13,47,76,2017
Iceland,Iceland,Free,1,1,12,16,10,38,16,12,15,16,59,97,2017
India,India,Free,2,3,12,14,9,35,13,10,9,10,42,77,2017
Indian Kashmir,Indian Kashmir,Partly Free,4,4,9,9,4,22,9,5,6,8,28,50,2017
Indonesia,Indonesia,Partly Free,2,4,11,14,6,31,12,8,5,9,34,65,2017
Iran,Iran,Not Free,6,6,3,2,2,7,2,1,3,4,10,17,2017
Iraq,Iraq,Not Free,5,6,8,5,2,12,5,6,0,4,15,27,2017
Ireland,Ireland,Free,1,1,12,16,11,39,16,12,14,15,57,96,2017
Israel,Israel,Free,1,2,12,14,10,36,12,10,11,11,44,80,2017
Italy,Italy,Free,1,1,12,14,10,36,15,12,12,14,53,89,2017
Jamaica,Jamaica,Free,2,3,12,13,9,34,15,9,7,10,41,75,2017
Japan,Japan,Free,1,1,12,16,12,40,15,12,15,14,56,96,2017
Jordan,Jordan,Partly Free,5,5,3,6,3,12,7,4,6,8,25,37,2017
Kazakhstan,Kazakhstan,Not Free,7,5,1,3,1,5,4,1,4,8,17,22,2017
Kenya,Kenya,Partly Free,4,4,7,10,5,22,10,7,5,7,29,51,2017
Kiribati,Kiribati,Free,1,1,12,16,9,37,15,12,15,13,55,92,2017
Kosovo,Kosovo,Partly Free,3,4,9,10,5,24,9,6,6,7,28,52,2017
Kuwait,Kuwait,Partly Free,5,5,2,7,4,13,6,4,7,6,23,36,2017
Kyrgyzstan,Kyrgyzstan,Partly Free,5,5,5,6,4,13,9,4,4,7,24,37,2017
Laos,Laos,Not Free,7,6,0,0,1,1,4,0,2,5,11,12,2017
Latvia,Latvia,Free,1,2,12,15,9,36,15,12,12,12,51,87,2017
Lebanon,Lebanon,Partly Free,5,4,3,9,2,14,11,7,5,7,30,44,2017
Lesotho,Lesotho,Partly Free,3,3,10,11,6,27,12,7,9,9,37,64,2017
Liberia,Liberia,Partly Free,3,4,9,12,7,28,11,8,7,8,34,62,2017
Libya,Libya,Not Free,7,6,1,2,0,3,4,2,0,4,10,13,2017
Liechtenstein,Liechtenstein,Free,2,1,10,13,10,33,16,12,14,16,58,91,2017
Lithuania,Lithuania,Free,1,1,12,16,10,38,16,11,13,13,53,91,2017
Luxembourg,Luxembourg,Free,1,1,12,16,10,38,16,12,16,16,60,98,2017
Madagascar,Madagascar,Partly Free,3,4,9,10,5,24,10,8,6,8,32,56,2017
Malawi,Malawi,Partly Free,3,3,8,12,6,26,13,8,9,7,37,63,2017
Malaysia,Malaysia,Partly Free,4,4,6,7,5,18,7,5,5,9,26,44,2017
Maldives,Maldives,Partly Free,5,5,7,5,5,17,5,5,6,7,23,40,2017
Mali,Mali,Partly Free,5,4,6,7,4,17,12,6,6,4,28,45,2017
Malta,Malta,Free,1,1,12,16,11,39,16,12,15,14,57,96,2017
Marshall Islands,Marshall Islands,Free,1,1,12,15,10,37,16,11,15,13,55,92,2017
Mauritania,Mauritania,Not Free,6,5,3,2,4,9,9,4,4,4,21,30,2017
Mauritius,Mauritius,Free,1,2,12,15,10,37,15,12,13,12,52,89,2017
Mexico,Mexico,Partly Free,3,3,9,12,7,28,13,8,6,10,37,65,2017
Micronesia,Micronesia,Free,1,1,12,15,10,37,16,11,15,14,56,93,2017
Moldova,Moldova,Partly Free,3,3,10,12,5,27,12,8,6,9,35,62,2017
Monaco,Monaco,Free,3,1,7,11,9,27,16,12,15,14,57,84,2017
Mongolia,Mongolia,Free,1,2,11,16,9,36,14,11,12,12,49,85,2017
Montenegro,Montenegro,Partly Free,3,3,8,11,7,26,12,9,10,12,43,69,2017
Morocco,Morocco,Partly Free,5,4,5,7,3,15,7,6,6,7,26,41,2017
Mozambique,Mozambique,Partly Free,4,4,6,9,5,20,11,7,7,8,33,53,2017
Myanmar,Myanmar,Partly Free,5,5,5,8,4,14,7,5,1,5,18,32,2017
Nagorno-Karabakh,Nagorno-Karabakh,Partly Free,5,5,6,6,3,15,6,3,4,5,18,33,2017
Namibia,Namibia,Free,2,2,10,11,9,30,14,12,11,10,47,77,2017
Nauru,Nauru,Free,2,2,12,15,8,35,13,9,10,14,46,81,2017
Nepal,Nepal,Partly Free,3,4,9,10,5,24,9,5,6,8,28,52,2017
Netherlands,Netherlands,Free,1,1,12,16,12,40,16,12,15,16,59,99,2017
New Zealand,New Zealand,Free,1,1,12,16,12,40,16,12,15,15,58,98,2017
Nicaragua,Nicaragua,Partly Free,5,4,3,6,5,14,11,5,7,10,33,47,2017
Niger,Niger,Partly Free,4,4,6,9,6,21,11,6,5,6,28,49,2017
Nigeria,Nigeria,Partly Free,3,5,9,10,6,25,9,7,4,5,25,50,2017
North Korea,North Korea,Not Free,7,7,0,0,0,0,0,0,0,3,3,3,2017
Macedonia,North Macedonia,Partly Free,4,3,6,10,5,21,10,8,8,10,36,57,2017
Northern Cyprus,Northern Cyprus,Free,2,2,11,12,9,32,14,11,12,11,48,80,2017
Norway,Norway,Free,1,1,12,16,12,40,16,12,16,16,60,100,2017
Oman,Oman,Not Free,6,5,2,2,2,8,5,3,4,5,17,25,2017
Pakistan,Pakistan,Partly Free,4,5,7,8,6,21,6,6,4,6,22,43,2017
Pakistani Kashmir,Pakistani Kashmir,Not Free,6,5,4,4,3,9,6,4,3,6,19,28,2017
Palau,Palau,Free,1,1,12,15,10,37,16,11,15,13,55,92,2017
Panama,Panama,Free,2,2,12,15,8,35,15,11,10,12,48,83,2017
Papua New Guinea,Papua New Guinea,Partly Free,3,3,9,13,4,26,13,9,7,9,38,64,2017
Paraguay,Paraguay,Partly Free,3,3,10,12,5,27,12,8,7,10,37,64,2017
Peru,Peru,Free,2,3,11,13,7,31,15,8,8,10,41,72,2017
Philippines,Philippines,Partly Free,3,3,9,11,7,27,14,8,4,10,36,63,2017
Poland,Poland,Free,1,2,12,16,9,37,14,12,12,14,52,89,2017
Portugal,Portugal,Free,1,1,12,16,11,39,16,12,15,15,58,97,2017
Qatar,Qatar,Not Free,6,5,2,2,3,9,7,2,4,4,17,26,2017
Romania,Romania,Free,2,2,11,14,10,35,14,11,12,12,49,84,2017
Russia,Russia,Not Free,7,6,0,3,2,5,3,3,2,7,15,20,2017
Rwanda,Rwanda,Not Free,6,6,2,1,5,8,4,2,3,7,16,24,2017
Samoa,Samoa,Free,2,2,9,12,9,30,14,10,14,12,50,80,2017
San Marino,San Marino,Free,1,1,12,15,11,38,15,12,16,16,59,97,2017
Sao Tome and Principe,Sao Tome and Principe,Free,2,2,11,14,9,34,15,10,12,10,47,81,2017
Saudi Arabia,Saudi Arabia,Not Free,7,7,0,0,1,3,3,0,2,2,7,10,2017
Senegal,Senegal,Free,2,2,11,13,8,32,15,10,10,11,46,78,2017
Serbia,Serbia,Free,3,2,9,13,7,29,14,10,10,13,47,76,2017
Seychelles,Seychelles,Partly Free,3,3,10,11,7,28,12,9,11,11,43,71,2017
Sierra Leone,Sierra Leone,Partly Free,3,3,10,11,7,28,12,7,9,10,38,66,2017
Singapore,Singapore,Partly Free,4,4,4,8,7,19,9,4,7,12,32,51,2017
Slovakia,Slovakia,Free,1,1,12,15,9,36,15,12,12,14,53,89,2017
Slovenia,Slovenia,Free,1,1,12,16,11,39,14,12,14,13,53,92,2017
Solomon Islands,Solomon Islands,Free,3,2,9,13,5,27,14,9,9,12,44,71,2017
Somalia,Somalia,Not Free,7,7,0,0,0,0,3,1,0,1,5,5,2017
Somaliland,Somaliland,Partly Free,5,5,2,9,4,15,7,5,7,6,25,40,2017
South Africa,South Africa,Free,2,2,12,14,7,33,15,11,9,10,45,78,2017
South Korea,South Korea,Free,2,2,11,13,8,32,13,11,13,13,50,82,2017
South Ossetia,South Ossetia,Not Free,7,6,2,2,0,2,4,1,1,3,9,11,2017
South Sudan,South Sudan,Not Free,7,7,1,1,0,-2,4,2,0,0,6,4,2017
Spain,Spain,Free,1,1,12,16,10,38,15,11,15,15,56,94,2017
Sri Lanka,Sri Lanka,Partly Free,3,4,8,10,7,24,9,8,7,8,32,56,2017
St. Kitts and Nevis,St. Kitts and Nevis,Free,1,1,10,16,10,36,15,12,13,13,53,89,2017
St. Lucia,St. Lucia,Free,1,1,12,16,11,39,15,12,12,14,53,92,2017
St. Vincent and the Grenadines,St. Vincent and the Grenadines,Free,1,1,11,16,10,37,15,12,13,14,54,91,2017
Sudan,Sudan,Not Free,7,7,2,3,1,2,2,1,0,1,4,6,2017
Suriname,Suriname,Free,2,3,12,14,8,34,15,11,7,10,43,77,2017
Sweden,Sweden,Free,1,1,12,16,12,40,16,12,16,16,60,100,2017
Switzerland,Switzerland,Free,1,1,12,15,12,39,15,12,15,15,57,96,2017
Syria,Syria,Not Free,7,7,0,0,0,-3,2,0,0,0,2,-1,2017
Taiwan,Taiwan,Free,1,1,12,15,10,37,16,11,14,13,54,91,2017
Tajikistan,Tajikistan,Not Free,7,6,0,0,1,1,2,2,2,4,10,11,2017
Tanzania,Tanzania,Partly Free,3,4,7,11,7,25,9,6,9,9,33,58,2017
Thailand,Thailand,Not Free,6,5,1,3,3,7,6,4,5,10,25,32,2017
Gambia,The Gambia,Not Free,6,6,3,5,0,8,3,2,1,6,12,20,2017
Tibet,Tibet,Not Free,7,7,0,0,1,-2,0,0,0,3,3,1,2017
Timor-Leste,Timor-Leste,Partly Free,3,3,11,12,6,29,12,8,7,9,36,65,2017
Togo,Togo,Partly Free,4,4,6,7,5,18,9,7,7,7,30,48,2017
Tonga,Tonga,Free,2,2,9,14,7,30,12,9,11,12,44,74,2017
Transnistria,Transnistria,Not Free,6,6,3,5,2,10,5,2,2,5,14,24,2017
Trinidad and Tobago,Trinidad and Tobago,Free,2,2,11,13,9,33,15,11,9,13,48,81,2017
Tunisia,Tunisia,Free,1,3,11,16,9,36,13,9,9,11,42,78,2017
Turkey,Turkey,Partly Free,4,5,8,7,3,18,6,3,4,7,20,38,2017
Turkmenistan,Turkmenistan,Not Free,7,7,0,0,0,0,1,0,0,3,4,4,2017
Tuvalu,Tuvalu,Free,1,1,12,15,10,37,16,12,15,14,57,94,2017
Uganda,Uganda,Not Free,6,5,3,5,3,11,9,4,4,7,24,35,2017
Ukraine,Ukraine,Partly Free,3,3,9,10,6,25,11,9,6,10,36,61,2017
United Arab Emirates,United Arab Emirates,Not Free,6,6,1,2,2,7,4,2,3,4,13,20,2017
United Kingdom,United Kingdom,Free,1,1,12,16,12,40,14,12,14,15,55,95,2017
United States,United States,Free,1,1,11,14,11,36,16,10,12,15,53,89,2017
Uruguay,Uruguay,Free,1,1,12,16,12,40,16,12,15,15,58,98,2017
Uzbekistan,Uzbekistan,Not Free,7,7,0,0,0,0,0,0,0,3,3,3,2017
Vanuatu,Vanuatu,Free,2,2,10,15,7,32,15,11,11,11,48,80,2017
Venezuela,Venezuela,Not Free,6,5,5,6,0,11,8,3,1,7,19,30,2017
Vietnam,Vietnam,Not Free,7,5,0,1,2,3,4,1,4,8,17,20,2017
West Bank,West Bank,Not Free,7,5,2,4,2,5,8,5,5,5,23,28,2017
Western Sahara,Western Sahara,Not Free,7,7,0,0,0,-3,3,0,0,4,7,4,2017
Yemen,Yemen,Not Free,7,6,0,1,1,2,5,3,2,2,12,14,2017
Zambia,Zambia,Partly Free,4,4,6,11,6,23,10,7,8,8,33,56,2017
Zimbabwe,Zimbabwe,Partly Free,5,5,3,6,3,12,8,4,3,5,20,32,2017
Abkhazia,Abkhazia,Partly Free,4,5,6,8,5,19,8,6,4,5,23,42,2016
Afghanistan,Afghanistan,Not Free,6,6,2,6,2,10,6,4,2,2,14,24,2016
Albania,Albania,Partly Free,3,3,8,13,6,27,13,9,9,9,40,67,2016
Algeria,Algeria,Not Free,6,5,4,4,3,11,7,5,5,7,24,35,2016
Andorra,Andorra,Free,1,1,12,15,12,39,16,11,15,15,57,96,2016
Angola,Angola,Not Free,6,6,3,6,1,10,5,3,3,3,14,24,2016
Antigua and Barbuda,Antigua and Barbuda,Free,2,2,12,13,8,33,14,9,13,13,49,82,2016
Argentina,Argentina,Free,2,2,11,14,6,31,14,11,10,13,48,79,2016
Armenia,Armenia,Partly Free,5,4,5,7,4,16,9,6,6,9,30,46,2016
Australia,Australia,Free,1,1,12,16,12,40,16,12,15,15,58,98,2016
Austria,Austria,Free,1,1,12,15,10,37,16,12,15,15,58,95,2016
Azerbaijan,Azerbaijan,Not Free,7,6,1,3,1,5,3,1,2,5,11,16,2016
Bahamas,Bahamas,Free,1,1,12,16,10,38,16,12,13,13,54,92,2016
Bahrain,Bahrain,Not Free,7,6,2,2,3,4,2,1,1,6,10,14,2016
Bangladesh,Bangladesh,Partly Free,4,4,7,9,5,21,7,6,6,9,28,49,2016
Barbados,Barbados,Free,1,1,12,16,12,40,16,12,15,15,58,98,2016
Belarus,Belarus,Not Free,7,6,0,3,1,4,3,1,2,7,13,17,2016
Belgium,Belgium,Free,1,1,12,16,12,40,15,12,14,15,56,96,2016
Belize,Belize,Free,1,2,12,14,10,36,15,11,12,13,51,87,2016
Benin,Benin,Free,2,2,9,16,8,33,15,12,12,10,49,82,2016
Bhutan,Bhutan,Partly Free,3,4,10,10,10,29,9,4,6,8,27,56,2016
Bolivia,Bolivia,Partly Free,3,3,11,11,7,29,14,9,6,10,39,68,2016
Bosnia and Herzegovina,Bosnia and Herzegovina,Partly Free,4,3,8,10,4,22,10,7,8,10,35,57,2016
Botswana,Botswana,Free,3,2,10,10,8,28,12,10,12,11,45,73,2016
Brazil,Brazil,Free,2,2,11,14,8,33,15,10,10,13,48,81,2016
Brunei,Brunei,Not Free,6,5,0,3,3,7,6,3,6,7,22,29,2016
Bulgaria,Bulgaria,Free,2,2,11,14,8,33,14,11,10,12,47,80,2016
Burkina Faso,Burkina Faso,Partly Free,4,3,6,9,6,21,14,8,8,8,38,59,2016
Burundi,Burundi,Not Free,7,6,1,4,0,5,6,2,1,5,14,19,2016
Cape Verde,Cabo Verde,Free,1,1,12,15,10,37,15,11,14,13,53,90,2016
Cambodia,Cambodia,Not Free,6,5,4,4,3,11,9,3,3,6,21,32,2016
Cameroon,Cameroon,Not Free,6,6,3,3,3,9,7,3,1,4,15,24,2016
Canada,Canada,Free,1,1,12,16,12,40,16,12,15,16,59,99,2016
Central African Republic,Central African Republic,Not Free,7,7,1,1,0,1,4,1,0,1,6,7,2016
Chad,Chad,Not Free,7,6,2,1,1,4,7,5,1,3,16,20,2016
Chile,Chile,Free,1,1,12,15,11,38,16,12,14,15,57,95,2016
China,China,Not Free,7,6,0,1,2,1,4,3,2,6,15,16,2016
Colombia,Colombia,Partly Free,3,4,10,11,8,29,12,5,7,10,34,63,2016
Comoros,Comoros,Partly Free,3,4,9,11,4,24,10,7,8,6,31,55,2016
Congo,Congo (Brazzaville),Not Free,6,5,1,2,3,6,7,6,2,7,22,28,2016
DR Congo,Congo (Kinshasa),Not Free,6,6,3,4,2,9,8,3,0,5,16,25,2016
Costa Rica,Costa Rica,Free,1,1,12,15,10,37,16,11,13,13,53,90,2016
Cote d'Ivoire,Cote d'Ivoire,Partly Free,4,4,7,8,5,20,11,7,6,7,31,51,2016
Crimea,Crimea,Not Free,7,6,0,0,0,-1,3,1,0,6,10,9,2016
Croatia,Croatia,Free,1,2,12,15,10,37,14,12,11,13,50,87,2016
Cuba,Cuba,Not Free,7,6,0,0,1,1,5,0,3,6,14,15,2016
Cyprus,Cyprus,Free,1,1,11,16,11,38,15,12,15,14,56,94,2016
Czech Republic,Czech Republic,Free,1,1,12,15,11,38,16,12,14,15,57,95,2016
Denmark,Denmark,Free,1,1,12,16,12,40,16,12,15,15,58,98,2016
Djibouti,Djibouti,Not Free,6,5,3,3,3,9,6,3,4,6,19,28,2016
Dominica,Dominica,Free,1,1,12,16,10,38,15,12,15,15,57,95,2016
Dominican Republic,Dominican Republic,Partly Free,3,3,10,10,9,29,14,10,8,9,41,70,2016
Ecuador,Ecuador,Partly Free,3,3,7,11,6,24,12,7,6,10,35,59,2016
Egypt,Egypt,Not Free,6,5,3,4,2,9,5,4,2,7,18,27,2016
El Salvador,El Salvador,Free,2,3,10,14,9,33,12,8,8,8,36,69,2016
Equatorial Guinea,Equatorial Guinea,Not Free,7,7,0,1,0,1,4,0,0,3,7,8,2016
Eritrea,Eritrea,Not Free,7,7,0,0,1,1,0,0,0,2,2,3,2016
Estonia,Estonia,Free,1,1,12,15,11,38,16,12,14,14,56,94,2016
Eswatini,Eswatini,Not Free,7,5,0,1,0,1,7,2,4,4,17,18,2016
Ethiopia,Ethiopia,Not Free,7,6,1,0,3,4,3,0,3,5,11,15,2016
Fiji,Fiji,Partly Free,3,3,9,11,7,27,11,5,9,10,35,62,2016
Finland,Finland,Free,1,1,12,16,12,40,16,12,16,16,60,100,2016
France,France,Free,1,1,12,15,11,38,14,11,13,15,53,91,2016
Gabon,Gabon,Not Free,6,5,2,4,3,9,10,4,6,5,25,34,2016
Gaza Strip,Gaza Strip,Not Free,7,6,0,2,1,3,4,3,0,2,9,12,2016
Georgia,Georgia,Partly Free,3,3,9,11,7,27,11,8,8,10,37,64,2016
Germany,Germany,Free,1,1,12,15,12,39,15,12,14,15,56,95,2016
Ghana,Ghana,Free,1,2,12,15,10,37,14,11,11,10,46,83,2016
Greece,Greece,Free,2,2,12,15,8,35,14,11,10,13,48,83,2016
Grenada,Grenada,Free,1,2,12,16,10,38,15,11,12,13,51,89,2016
Guatemala,Guatemala,Partly Free,4,4,8,10,5,23,12,6,5,8,31,54,2016
Guinea,Guinea,Partly Free,5,5,6,8,3,17,9,5,4,5,23,40,2016
Guinea-Bissau,Guinea-Bissau,Partly Free,5,5,7,8,1,16,10,5,3,5,23,39,2016
Guyana,Guyana,Free,2,3,11,13,8,32,15,10,8,9,42,74,2016
Haiti,Haiti,Partly Free,5,5,4,8,5,17,10,4,4,6,24,41,2016
Honduras,Honduras,Partly Free,4,4,7,9,3,19,9,5,4,8,26,45,2016
Hong Kong,Hong Kong,Partly Free,5,2,3,7,6,16,12,8,14,13,47,63,2016
Hungary,Hungary,Free,2,2,9,15,8,32,13,11,10,13,47,79,2016
Iceland,Iceland,Free,1,1,12,16,12,40,16,12,16,16,60,100,2016
India,India,Free,2,3,12,14,9,35,13,10,9,10,42,77,2016
Indian Kashmir,Indian Kashmir,Partly Free,4,4,9,9,4,22,9,6,6,8,29,51,2016
Indonesia,Indonesia,Partly Free,2,4,11,14,6,31,12,8,5,9,34,65,2016
Iran,Iran,Not Free,6,6,3,2,2,7,2,1,3,4,10,17,2016
Iraq,Iraq,Not Free,5,6,8,5,2,12,5,6,0,4,15,27,2016
Ireland,Ireland,Free,1,1,12,16,11,39,16,12,14,15,57,96,2016
Israel,Israel,Free,1,2,12,14,10,36,12,10,11,11,44,80,2016
Italy,Italy,Free,1,1,12,14,10,36,15,12,12,14,53,89,2016
Jamaica,Jamaica,Free,2,3,12,13,9,34,15,9,7,10,41,75,2016
Japan,Japan,Free,1,1,12,16,12,40,15,12,15,14,56,96,2016
Jordan,Jordan,Not Free,6,5,2,6,3,11,7,4,6,8,25,36,2016
Kazakhstan,Kazakhstan,Not Free,6,5,2,3,1,6,4,2,4,8,18,24,2016
Kenya,Kenya,Partly Free,4,4,7,10,5,22,11,6,5,7,29,51,2016
Kiribati,Kiribati,Free,1,1,12,16,8,36,15,12,15,13,55,91,2016
Kosovo,Kosovo,Partly Free,3,4,9,10,5,24,9,6,6,7,28,52,2016
Kuwait,Kuwait,Partly Free,5,5,2,7,4,13,6,4,7,6,23,36,2016
Kyrgyzstan,Kyrgyzstan,Partly Free,5,5,6,6,4,14,9,4,4,7,24,38,2016
Laos,Laos,Not Free,7,6,0,0,1,1,4,0,2,5,11,12,2016
Latvia,Latvia,Free,2,2,12,14,9,35,15,12,12,12,51,86,2016
Lebanon,Lebanon,Partly Free,5,4,2,9,2,13,11,7,5,7,30,43,2016
Lesotho,Lesotho,Partly Free,3,3,10,12,6,28,14,7,9,9,39,67,2016
Liberia,Liberia,Partly Free,3,4,9,12,7,28,10,8,7,8,33,61,2016
Libya,Libya,Not Free,6,6,4,2,0,6,6,3,1,4,14,20,2016
Liechtenstein,Liechtenstein,Free,1,1,12,15,12,39,16,12,15,16,59,98,2016
Lithuania,Lithuania,Free,1,1,12,16,10,38,16,11,13,13,53,91,2016
Luxembourg,Luxembourg,Free,1,1,12,16,10,38,16,12,16,16,60,98,2016
Madagascar,Madagascar,Partly Free,3,4,9,10,5,24,10,8,6,8,32,56,2016
Malawi,Malawi,Partly Free,3,3,8,12,7,27,13,8,9,7,37,64,2016
Malaysia,Malaysia,Partly Free,4,4,6,7,5,18,7,6,5,9,27,45,2016
Maldives,Maldives,Partly Free,4,5,7,6,6,19,6,5,6,7,24,43,2016
Mali,Mali,Partly Free,5,4,6,7,4,17,12,6,6,4,28,45,2016
Malta,Malta,Free,1,1,12,16,11,39,16,12,15,14,57,96,2016
Marshall Islands,Marshall Islands,Free,1,1,12,15,10,37,16,11,15,13,55,92,2016
Mauritania,Mauritania,Not Free,6,5,3,2,4,9,9,4,4,4,21,30,2016
Mauritius,Mauritius,Free,1,2,12,15,11,38,15,12,13,12,52,90,2016
Mexico,Mexico,Partly Free,3,3,9,12,7,28,13,8,6,10,37,65,2016
Micronesia,Micronesia,Free,1,1,12,15,10,37,16,11,15,14,56,93,2016
Moldova,Moldova,Partly Free,3,3,10,11,4,25,11,8,7,9,35,60,2016
Monaco,Monaco,Free,2,1,10,11,10,31,16,12,15,14,57,88,2016
Mongolia,Mongolia,Free,1,2,11,16,9,36,15,11,12,12,50,86,2016
Montenegro,Montenegro,Partly Free,3,3,9,11,7,27,12,9,10,12,43,70,2016
Morocco,Morocco,Partly Free,5,4,5,7,3,15,8,5,6,7,26,41,2016
Mozambique,Mozambique,Partly Free,4,4,6,10,6,22,11,7,7,9,34,56,2016
Myanmar,Myanmar,Not Free,6,5,3,8,3,11,7,4,1,5,17,28,2016
Nagorno-Karabakh,Nagorno-Karabakh,Partly Free,5,5,6,6,3,15,6,3,4,5,18,33,2016
Namibia,Namibia,Free,2,2,10,11,9,30,14,12,11,10,47,77,2016
Nauru,Nauru,Free,2,2,12,15,8,35,13,10,12,14,49,84,2016
Nepal,Nepal,Partly Free,3,4,9,11,5,25,9,5,5,7,26,51,2016
Netherlands,Netherlands,Free,1,1,12,16,12,40,16,12,15,16,59,99,2016
New Zealand,New Zealand,Free,1,1,12,16,12,40,16,12,15,15,58,98,2016
Nicaragua,Nicaragua,Partly Free,4,3,6,7,6,19,12,6,7,10,35,54,2016
Niger,Niger,Partly Free,3,4,8,9,7,24,11,6,5,6,28,52,2016
Nigeria,Nigeria,Partly Free,4,5,9,10,5,23,9,7,4,5,25,48,2016
North Korea,North Korea,Not Free,7,7,0,0,0,0,0,0,0,3,3,3,2016
Macedonia,North Macedonia,Partly Free,4,3,6,10,6,22,10,8,7,10,35,57,2016
Northern Cyprus,Northern Cyprus,Free,2,2,11,12,9,32,14,9,12,12,47,79,2016
Norway,Norway,Free,1,1,12,16,12,40,16,12,16,16,60,100,2016
Oman,Oman,Not Free,6,5,2,2,2,8,5,3,4,5,17,25,2016
Pakistan,Pakistan,Partly Free,4,5,7,8,5,20,5,6,4,6,21,41,2016
Pakistani Kashmir,Pakistani Kashmir,Not Free,6,5,4,4,3,9,6,4,3,6,19,28,2016
Palau,Palau,Free,1,1,12,15,10,37,16,11,15,13,55,92,2016
Panama,Panama,Free,2,2,12,15,8,35,15,11,10,12,48,83,2016
Papua New Guinea,Papua New Guinea,Partly Free,4,3,9,10,4,23,12,9,7,8,36,59,2016
Paraguay,Paraguay,Partly Free,3,3,10,12,5,27,12,8,7,10,37,64,2016
Peru,Peru,Free,2,3,10,13,7,30,15,8,8,10,41,71,2016
Philippines,Philippines,Partly Free,3,3,9,11,7,27,14,9,5,10,38,65,2016
Poland,Poland,Free,1,1,12,16,10,38,16,12,13,14,55,93,2016
Portugal,Portugal,Free,1,1,12,16,11,39,16,12,15,15,58,97,2016
Puerto Rico,Puerto Rico,Free,1,1,12,15,10,37,16,11,12,14,53,90,2016
Qatar,Qatar,Not Free,6,5,2,2,3,9,8,2,4,4,18,27,2016
Romania,Romania,Free,2,2,11,14,9,34,14,11,12,12,49,83,2016
Russia,Russia,Not Free,6,6,1,3,3,7,3,3,2,7,15,22,2016
Rwanda,Rwanda,Not Free,6,6,2,1,5,8,4,2,3,7,16,24,2016
Samoa,Samoa,Free,2,2,9,13,9,31,14,10,13,12,49,80,2016
San Marino,San Marino,Free,1,1,12,16,12,40,16,12,16,16,60,100,2016
Sao Tome and Principe,Sao Tome and Principe,Free,2,2,11,14,9,34,15,10,12,10,47,81,2016
Saudi Arabia,Saudi Arabia,Not Free,7,7,0,0,1,3,3,0,2,2,7,10,2016
Senegal,Senegal,Free,2,2,11,13,9,33,15,10,10,10,45,78,2016
Serbia,Serbia,Free,2,2,10,13,7,30,14,11,10,13,48,78,2016
Seychelles,Seychelles,Partly Free,3,3,9,10,7,26,11,9,11,11,42,68,2016
Sierra Leone,Sierra Leone,Partly Free,3,3,10,11,7,28,12,7,9,9,37,65,2016
Singapore,Singapore,Partly Free,4,4,4,8,7,19,9,4,7,12,32,51,2016
Slovakia,Slovakia,Free,1,1,12,15,9,36,15,12,12,14,53,89,2016
Slovenia,Slovenia,Free,1,1,12,16,11,39,14,12,14,13,53,92,2016
Solomon Islands,Solomon Islands,Partly Free,3,3,9,10,6,25,14,9,8,12,43,68,2016
Somalia,Somalia,Not Free,7,7,0,0,0,0,1,0,0,1,2,2,2016
Somaliland,Somaliland,Partly Free,5,5,2,9,4,15,7,5,7,6,25,40,2016
South Africa,South Africa,Free,2,2,12,13,8,33,15,12,9,10,46,79,2016
South Korea,South Korea,Free,2,2,11,13,10,34,12,11,13,13,49,83,2016
South Ossetia,South Ossetia,Not Free,7,6,2,2,0,2,4,1,1,3,9,11,2016
South Sudan,South Sudan,Not Free,7,6,3,1,1,2,4,3,1,4,12,14,2016
Spain,Spain,Free,1,1,12,16,11,39,15,11,15,15,56,95,2016
Sri Lanka,Sri Lanka,Partly Free,4,4,8,10,6,23,9,8,7,8,32,55,2016
St. Kitts and Nevis,St. Kitts and Nevis,Free,2,1,10,16,9,35,15,12,13,13,53,88,2016
St. Lucia,St. Lucia,Free,1,1,12,16,11,39,15,12,12,14,53,92,2016
St. Vincent and the Grenadines,St. Vincent and the Grenadines,Free,1,1,11,16,10,37,15,12,13,14,54,91,2016
Sudan,Sudan,Not Free,7,7,2,3,1,2,2,1,0,1,4,6,2016
Suriname,Suriname,Free,2,3,12,14,8,34,15,11,7,10,43,77,2016
Sweden,Sweden,Free,1,1,12,16,12,40,16,12,16,16,60,100,2016
Switzerland,Switzerland,Free,1,1,12,15,12,39,15,12,15,15,57,96,2016
Syria,Syria,Not Free,7,7,0,0,0,-3,2,0,0,0,2,-1,2016
Taiwan,Taiwan,Free,1,2,12,15,10,37,14,11,14,13,52,89,2016
Tajikistan,Tajikistan,Not Free,7,6,1,0,1,2,4,3,3,4,14,16,2016
Tanzania,Tanzania,Partly Free,3,4,8,12,7,27,9,6,9,9,33,60,2016
Thailand,Thailand,Not Free,6,5,1,3,3,7,6,4,5,10,25,32,2016
Gambia,The Gambia,Not Free,7,6,1,4,0,5,3,3,1,6,13,18,2016
Tibet,Tibet,Not Free,7,7,0,0,1,-2,0,0,0,3,3,1,2016
Timor-Leste,Timor-Leste,Partly Free,3,3,11,12,6,29,12,8,7,9,36,65,2016
Togo,Togo,Partly Free,4,4,6,7,5,18,9,7,7,7,30,48,2016
Tonga,Tonga,Free,2,2,11,14,6,31,13,8,11,12,44,75,2016
Transnistria,Transnistria,Not Free,6,6,3,5,2,10,5,2,2,5,14,24,2016
Trinidad and Tobago,Trinidad and Tobago,Free,2,2,11,13,9,33,15,11,9,13,48,81,2016
Tunisia,Tunisia,Free,1,3,12,16,9,37,13,9,9,11,42,79,2016
Turkey,Turkey,Partly Free,3,4,9,9,6,24,8,6,6,9,29,53,2016
Turkmenistan,Turkmenistan,Not Free,7,7,0,0,0,0,1,0,0,3,4,4,2016
Tuvalu,Tuvalu,Free,1,1,12,15,10,37,16,12,15,14,57,94,2016
Uganda,Uganda,Not Free,6,5,3,5,3,11,9,4,5,7,25,36,2016
Ukraine,Ukraine,Partly Free,3,3,9,10,6,25,11,9,6,10,36,61,2016
United Arab Emirates,United Arab Emirates,Not Free,6,6,1,2,2,7,4,2,3,4,13,20,2016
United Kingdom,United Kingdom,Free,1,1,12,16,12,40,13,12,15,15,55,95,2016
United States,United States,Free,1,1,11,15,10,36,15,11,13,15,54,90,2016
Uruguay,Uruguay,Free,1,1,12,16,12,40,16,12,15,15,58,98,2016
Uzbekistan,Uzbekistan,Not Free,7,7,0,0,0,0,0,0,0,3,3,3,2016
Vanuatu,Vanuatu,Free,2,2,9,15,7,31,15,11,10,11,47,78,2016
Venezuela,Venezuela,Partly Free,5,5,5,8,2,15,8,3,1,8,20,35,2016
Vietnam,Vietnam,Not Free,7,5,0,1,2,3,4,1,4,8,17,20,2016
West Bank,West Bank,Not Free,6,5,2,5,2,6,9,5,5,5,24,30,2016
Western Sahara,Western Sahara,Not Free,7,7,0,0,0,-3,3,0,0,4,7,4,2016
Yemen,Yemen,Not Free,7,6,2,1,1,4,5,3,2,3,13,17,2016
Zambia,Zambia,Partly Free,3,4,8,11,7,26,11,7,8,8,34,60,2016
Zimbabwe,Zimbabwe,Partly Free,5,5,3,6,3,12,8,4,3,5,20,32,2016
Abkhazia,Abkhazia,Partly Free,4,5,6,8,4,18,8,6,4,5,23,41,2015
Afghanistan,Afghanistan,Not Free,6,6,3,6,2,11,5,4,2,2,13,24,2015
Albania,Albania,Partly Free,3,3,8,13,6,27,13,9,9,9,40,67,2015
Algeria,Algeria,Not Free,6,5,4,4,3,11,7,4,5,7,23,34,2015
Andorra,Andorra,Free,1,1,12,15,12,39,16,11,15,15,57,96,2015
Angola,Angola,Not Free,6,5,3,6,1,10,7,4,4,3,18,28,2015
Antigua and Barbuda,Antigua and Barbuda,Free,2,2,11,13,7,31,14,9,13,13,49,80,2015
Argentina,Argentina,Free,2,2,11,14,6,31,14,11,11,13,49,80,2015
Armenia,Armenia,Partly Free,5,4,5,7,4,16,9,6,6,9,30,46,2015
Australia,Australia,Free,1,1,12,15,12,39,16,12,15,15,58,97,2015
Austria,Austria,Free,1,1,12,15,11,38,16,12,15,15,58,96,2015
Azerbaijan,Azerbaijan,Not Free,6,6,1,3,2,6,4,1,3,6,14,20,2015
Bahamas,Bahamas,Free,1,1,12,16,10,38,16,12,15,15,58,96,2015
Bahrain,Bahrain,Not Free,7,6,2,2,3,5,2,1,1,6,10,15,2015
Bangladesh,Bangladesh,Partly Free,4,4,7,9,5,21,8,6,6,9,29,50,2015
Barbados,Barbados,Free,1,1,12,16,12,40,16,12,16,15,59,99,2015
Belarus,Belarus,Not Free,7,6,0,3,1,4,3,1,1,5,10,14,2015
Belgium,Belgium,Free,1,1,12,16,12,40,15,12,15,15,57,97,2015
Belize,Belize,Free,1,2,12,14,10,36,15,11,12,13,51,87,2015
Benin,Benin,Free,2,2,8,16,8,32,15,12,12,10,49,81,2015
Bhutan,Bhutan,Partly Free,3,4,10,10,10,29,9,4,6,8,27,56,2015
Bolivia,Bolivia,Partly Free,3,3,11,11,7,29,14,9,6,10,39,68,2015
Bosnia and Herzegovina,Bosnia and Herzegovina,Partly Free,4,3,8,10,5,23,10,7,10,10,37,60,2015
Botswana,Botswana,Free,3,2,10,10,8,28,12,10,12,11,45,73,2015
Brazil,Brazil,Free,2,2,11,14,8,33,15,10,10,13,48,81,2015
Brunei,Brunei,Not Free,6,5,0,3,3,7,6,3,6,8,23,30,2015
Bulgaria,Bulgaria,Free,2,2,11,14,8,33,14,11,10,11,46,79,2015
Burkina Faso,Burkina Faso,Partly Free,6,3,2,6,1,9,13,8,7,8,36,45,2015
Burundi,Burundi,Not Free,6,5,4,5,2,11,8,3,4,6,21,32,2015
Cape Verde,Cabo Verde,Free,1,1,12,15,10,37,15,11,14,13,53,90,2015
Cambodia,Cambodia,Not Free,6,5,4,4,3,11,9,3,2,6,20,31,2015
Cameroon,Cameroon,Not Free,6,6,3,3,3,9,7,3,2,4,16,25,2015
Canada,Canada,Free,1,1,12,16,11,39,16,12,15,16,59,98,2015
Central African Republic,Central African Republic,Not Free,7,7,0,1,0,0,4,1,0,1,6,6,2015
Chad,Chad,Not Free,7,6,3,1,1,5,7,4,2,3,16,21,2015
Chile,Chile,Free,1,1,12,15,12,39,16,11,14,15,56,95,2015
China,China,Not Free,7,6,0,1,2,2,4,3,2,6,15,17,2015
Colombia,Colombia,Partly Free,3,4,10,11,8,29,12,5,7,10,34,63,2015
Comoros,Comoros,Partly Free,3,4,9,11,5,25,10,6,8,6,30,55,2015
Congo,Congo (Brazzaville),Not Free,6,5,1,3,3,7,8,6,2,7,23,30,2015
DR Congo,Congo (Kinshasa),Not Free,6,6,3,4,2,9,8,3,0,5,16,25,2015
Costa Rica,Costa Rica,Free,1,1,12,15,10,37,16,11,13,13,53,90,2015
Cote d'Ivoire,Cote d'Ivoire,Partly Free,5,4,6,7,4,17,10,7,6,6,29,46,2015
Crimea,Crimea,Not Free,7,6,0,0,0,-1,3,1,0,7,11,10,2015
Croatia,Croatia,Free,1,2,12,15,9,36,14,12,11,13,50,86,2015
Cuba,Cuba,Not Free,7,6,0,0,1,1,4,0,3,6,13,14,2015
Cyprus,Cyprus,Free,1,1,11,16,10,37,15,12,15,14,56,93,2015
Czech Republic,Czech Republic,Free,1,1,12,15,11,38,16,12,14,15,57,95,2015
Denmark,Denmark,Free,1,1,12,16,12,40,16,12,15,15,58,98,2015
Djibouti,Djibouti,Not Free,6,5,3,3,3,9,6,3,4,6,19,28,2015
Dominica,Dominica,Free,1,1,12,16,10,38,15,12,15,15,57,95,2015
Dominican Republic,Dominican Republic,Free,2,3,10,11,9,30,15,10,8,10,43,73,2015
Ecuador,Ecuador,Partly Free,3,3,7,11,6,24,12,7,6,10,35,59,2015
Egypt,Egypt,Not Free,6,5,2,4,2,8,5,4,2,7,18,26,2015
El Salvador,El Salvador,Free,2,3,12,14,9,35,15,8,8,9,40,75,2015
Equatorial Guinea,Equatorial Guinea,Not Free,7,7,0,1,0,1,4,0,0,3,7,8,2015
Eritrea,Eritrea,Not Free,7,7,0,0,1,1,0,0,0,2,2,3,2015
Estonia,Estonia,Free,1,1,12,15,12,39,16,12,14,14,56,95,2015
Eswatini,Eswatini,Not Free,7,5,0,1,0,1,6,2,5,4,17,18,2015
Ethiopia,Ethiopia,Not Free,6,6,1,2,4,7,3,0,3,5,11,18,2015
Fiji,Fiji,Partly Free,3,4,9,11,6,26,11,4,9,10,34,60,2015
Finland,Finland,Free,1,1,12,16,12,40,16,12,16,16,60,100,2015
France,France,Free,1,1,12,15,11,38,15,12,15,15,57,95,2015
Gabon,Gabon,Not Free,6,5,2,4,3,9,10,4,6,5,25,34,2015
Gaza Strip,Gaza Strip,Not Free,7,6,2,2,1,5,5,3,0,2,10,15,2015
Georgia,Georgia,Partly Free,3,3,9,10,7,26,12,8,8,10,38,64,2015
Germany,Germany,Free,1,1,12,15,12,39,15,12,15,15,57,96,2015
Ghana,Ghana,Free,1,2,12,15,10,37,14,11,12,10,47,84,2015
Greece,Greece,Free,2,2,12,15,8,35,14,11,10,13,48,83,2015
Grenada,Grenada,Free,1,2,12,16,10,38,15,11,12,13,51,89,2015
Guatemala,Guatemala,Partly Free,3,4,9,10,5,24,12,6,5,8,31,55,2015
Guinea,Guinea,Partly Free,5,5,6,8,3,17,9,6,4,5,24,41,2015
Guinea-Bissau,Guinea-Bissau,Partly Free,5,5,8,8,1,17,10,5,3,5,23,40,2015
Guyana,Guyana,Free,2,3,11,13,6,30,15,10,7,9,41,71,2015
Haiti,Haiti,Partly Free,5,5,4,8,5,17,10,4,4,6,24,41,2015
Honduras,Honduras,Partly Free,4,4,7,9,4,20,10,6,5,8,29,49,2015
Hong Kong,Hong Kong,Partly Free,5,2,3,7,6,16,13,8,15,13,49,65,2015
Hungary,Hungary,Free,2,2,9,15,8,32,14,11,11,14,50,82,2015
Iceland,Iceland,Free,1,1,12,16,11,39,16,12,16,16,60,99,2015
India,India,Free,2,3,12,14,9,35,13,11,9,10,43,78,2015
Indian Kashmir,Indian Kashmir,Partly Free,4,4,9,9,4,22,9,6,6,8,29,51,2015
Indonesia,Indonesia,Partly Free,2,4,10,14,6,30,12,8,5,9,34,64,2015
Iran,Iran,Not Free,6,6,3,2,2,7,2,1,3,4,10,17,2015
Iraq,Iraq,Not Free,6,6,8,5,1,11,5,4,0,4,13,24,2015
Ireland,Ireland,Free,1,1,12,16,11,39,16,12,15,15,58,97,2015
Israel,Israel,Free,1,2,12,14,10,36,12,10,11,11,44,80,2015
Italy,Italy,Free,1,1,12,14,10,36,15,12,12,14,53,89,2015
Jamaica,Jamaica,Free,2,3,12,13,9,34,15,9,6,10,40,74,2015
Japan,Japan,Free,1,1,12,15,12,39,15,11,15,14,55,94,2015
Jordan,Jordan,Not Free,6,5,2,6,3,11,7,4,6,8,25,36,2015
Kazakhstan,Kazakhstan,Not Free,6,5,2,3,1,6,4,2,4,8,18,24,2015
Kenya,Kenya,Partly Free,4,4,7,10,5,22,11,6,5,7,29,51,2015
Kiribati,Kiribati,Free,1,1,12,16,8,36,15,12,15,13,55,91,2015
Kosovo,Kosovo,Partly Free,4,4,9,10,4,23,9,6,6,8,29,52,2015
Kuwait,Kuwait,Partly Free,5,5,2,7,5,14,6,4,7,6,23,37,2015
Kyrgyzstan,Kyrgyzstan,Partly Free,5,5,6,6,4,14,9,4,4,7,24,38,2015
Laos,Laos,Not Free,7,6,0,0,1,1,4,0,2,5,11,12,2015
Latvia,Latvia,Free,2,2,12,14,8,34,15,12,12,12,51,85,2015
Lebanon,Lebanon,Partly Free,5,4,2,9,3,14,11,7,5,7,30,44,2015
Lesotho,Lesotho,Free,2,3,10,12,8,30,14,7,11,9,41,71,2015
Liberia,Liberia,Partly Free,3,4,9,11,6,26,10,7,6,7,30,56,2015
Libya,Libya,Not Free,6,6,5,3,0,8,6,3,1,5,15,23,2015
Liechtenstein,Liechtenstein,Free,1,1,12,15,12,39,16,12,15,16,59,98,2015
Lithuania,Lithuania,Free,1,1,12,16,10,38,16,11,13,13,53,91,2015
Luxembourg,Luxembourg,Free,1,1,12,16,10,38,16,12,16,16,60,98,2015
Madagascar,Madagascar,Partly Free,4,4,9,9,4,22,9,8,6,7,30,52,2015
Malawi,Malawi,Partly Free,3,4,8,12,7,27,11,7,9,7,34,61,2015
Malaysia,Malaysia,Partly Free,4,4,6,7,6,19,7,6,5,9,27,46,2015
Maldives,Maldives,Partly Free,4,4,7,7,6,20,6,7,7,8,28,48,2015
Mali,Mali,Partly Free,5,4,6,7,4,17,11,6,6,4,27,44,2015
Malta,Malta,Free,1,1,12,16,11,39,16,12,15,15,58,97,2015
Marshall Islands,Marshall Islands,Free,1,1,11,15,10,36,16,11,15,13,55,91,2015
Mauritania,Mauritania,Not Free,6,5,3,2,4,9,10,4,4,4,22,31,2015
Mauritius,Mauritius,Free,1,2,12,15,11,38,15,12,13,12,52,90,2015
Mexico,Mexico,Partly Free,3,3,9,12,7,28,12,8,6,10,36,64,2015
Micronesia,Micronesia,Free,1,1,12,15,10,37,16,11,15,14,56,93,2015
Moldova,Moldova,Partly Free,3,3,10,12,6,28,11,8,7,9,35,63,2015
Monaco,Monaco,Free,2,1,10,11,10,31,16,12,15,14,57,88,2015
Mongolia,Mongolia,Free,1,2,11,16,9,36,15,11,12,12,50,86,2015
Montenegro,Montenegro,Free,3,2,9,11,7,27,12,10,10,12,44,71,2015
Morocco,Morocco,Partly Free,5,4,5,7,3,15,8,6,6,7,27,42,2015
Mozambique,Mozambique,Partly Free,4,3,6,10,7,23,12,7,7,9,35,58,2015
Myanmar,Myanmar,Not Free,6,6,3,6,3,9,6,4,1,5,16,25,2015
Nagorno-Karabakh,Nagorno-Karabakh,Partly Free,5,5,4,5,3,12,6,3,4,5,18,30,2015
Namibia,Namibia,Free,2,2,10,11,9,30,14,12,11,9,46,76,2015
Nauru,Nauru,Free,1,2,12,16,9,37,14,11,12,14,51,88,2015
Nepal,Nepal,Partly Free,3,4,8,11,5,24,9,6,5,7,27,51,2015
Netherlands,Netherlands,Free,1,1,12,16,12,40,16,12,15,16,59,99,2015
New Zealand,New Zealand,Free,1,1,12,15,12,39,16,12,15,15,58,97,2015
Nicaragua,Nicaragua,Partly Free,4,3,6,7,6,19,12,6,7,10,35,54,2015
Niger,Niger,Partly Free,3,4,9,10,7,26,11,8,5,6,30,56,2015
Nigeria,Nigeria,Partly Free,4,5,6,9,4,18,9,7,4,5,25,43,2015
North Korea,North Korea,Not Free,7,7,0,0,0,0,0,0,0,3,3,3,2015
Macedonia,North Macedonia,Partly Free,4,3,7,10,6,23,11,8,8,10,37,60,2015
Northern Cyprus,Northern Cyprus,Free,2,2,11,12,9,32,14,9,12,12,47,79,2015
Norway,Norway,Free,1,1,12,16,12,40,16,12,16,16,60,100,2015
Oman,Oman,Not Free,6,5,2,2,2,9,5,3,4,5,17,26,2015
Pakistan,Pakistan,Partly Free,4,5,7,8,5,20,5,7,4,6,22,42,2015
Pakistani Kashmir,Pakistani Kashmir,Not Free,6,5,4,4,3,9,6,4,4,6,20,29,2015
Palau,Palau,Free,1,1,12,15,10,37,16,11,15,13,55,92,2015
Panama,Panama,Free,2,2,12,15,8,35,15,11,9,12,47,82,2015
Papua New Guinea,Papua New Guinea,Partly Free,4,3,9,10,4,23,12,9,7,8,36,59,2015
Paraguay,Paraguay,Partly Free,3,3,10,12,5,27,12,8,7,11,38,65,2015
Peru,Peru,Free,2,3,10,13,7,30,15,8,8,10,41,71,2015
Philippines,Philippines,Partly Free,3,3,9,10,7,26,14,8,5,10,37,63,2015
Poland,Poland,Free,1,1,12,16,10,38,16,12,13,14,55,93,2015
Portugal,Portugal,Free,1,1,12,16,11,39,16,12,15,15,58,97,2015
Puerto Rico,Puerto Rico,Free,1,2,12,15,10,37,16,10,12,14,52,89,2015
Qatar,Qatar,Not Free,6,5,2,2,3,10,8,2,4,4,18,28,2015
Romania,Romania,Free,2,2,11,14,9,34,14,11,12,12,49,83,2015
Russia,Russia,Not Free,6,6,1,3,3,7,4,4,2,6,16,23,2015
Rwanda,Rwanda,Not Free,6,6,2,2,5,9,4,2,3,7,16,25,2015
Samoa,Samoa,Free,2,2,9,13,10,32,14,10,13,12,49,81,2015
San Marino,San Marino,Free,1,1,12,16,12,40,16,12,16,16,60,100,2015
Sao Tome and Principe,Sao Tome and Principe,Free,2,2,11,14,9,34,15,10,12,10,47,81,2015
Saudi Arabia,Saudi Arabia,Not Free,7,7,0,0,1,3,3,0,2,2,7,10,2015
Senegal,Senegal,Free,2,2,11,13,9,33,15,10,10,10,45,78,2015
Serbia,Serbia,Free,2,2,10,14,7,31,15,11,10,13,49,80,2015
Seychelles,Seychelles,Partly Free,3,3,8,10,7,25,11,9,11,11,42,67,2015
Sierra Leone,Sierra Leone,Partly Free,3,3,10,11,7,28,12,7,9,9,37,65,2015
Singapore,Singapore,Partly Free,4,4,4,8,7,19,9,4,7,12,32,51,2015
Slovakia,Slovakia,Free,1,1,12,15,10,37,15,12,12,14,53,90,2015
Slovenia,Slovenia,Free,1,1,12,15,11,38,14,12,14,13,53,91,2015
Solomon Islands,Solomon Islands,Partly Free,3,3,9,10,6,25,14,9,8,12,43,68,2015
Somalia,Somalia,Not Free,7,7,0,0,0,0,1,0,0,1,2,2,2015
Somaliland,Somaliland,Partly Free,4,5,5,10,6,21,7,5,7,6,25,46,2015
South Africa,South Africa,Free,2,2,12,13,8,33,15,12,10,11,48,81,2015
South Korea,South Korea,Free,2,2,11,13,10,34,13,11,13,13,50,84,2015
South Ossetia,South Ossetia,Not Free,7,6,2,2,0,1,4,1,1,3,9,10,2015
South Sudan,South Sudan,Not Free,7,6,3,0,1,2,4,3,1,5,13,15,2015
Spain,Spain,Free,1,1,12,16,11,39,15,12,15,15,57,96,2015
Sri Lanka,Sri Lanka,Partly Free,5,5,6,7,4,16,6,6,5,8,25,41,2015
St. Kitts and Nevis,St. Kitts and Nevis,Free,1,1,12,16,9,37,15,12,13,13,53,90,2015
St. Lucia,St. Lucia,Free,1,1,12,16,11,39,15,12,12,14,53,92,2015
St. Vincent and the Grenadines,St. Vincent and the Grenadines,Free,1,1,11,16,9,36,15,12,13,14,54,90,2015
Sudan,Sudan,Not Free,7,7,2,3,1,2,2,1,0,1,4,6,2015
Suriname,Suriname,Free,2,2,12,13,8,33,15,11,8,10,44,77,2015
Sweden,Sweden,Free,1,1,12,16,12,40,15,12,16,16,59,99,2015
Switzerland,Switzerland,Free,1,1,12,15,12,39,15,12,15,15,57,96,2015
Syria,Syria,Not Free,7,7,0,0,0,-3,2,0,0,0,2,-1,2015
Taiwan,Taiwan,Free,1,2,12,15,10,37,14,10,14,13,51,88,2015
Tajikistan,Tajikistan,Not Free,6,6,2,3,2,7,5,3,3,4,15,22,2015
Tanzania,Tanzania,Partly Free,3,3,9,12,7,28,10,7,9,9,35,63,2015
Thailand,Thailand,Not Free,6,5,1,4,3,8,6,4,5,10,25,33,2015
Gambia,The Gambia,Not Free,6,6,2,5,0,7,3,3,1,6,13,20,2015
Tibet,Tibet,Not Free,7,7,0,0,1,-2,0,0,0,3,3,1,2015
Timor-Leste,Timor-Leste,Partly Free,3,3,11,12,6,29,12,8,7,9,36,65,2015
Togo,Togo,Partly Free,4,4,5,8,5,18,9,6,7,7,29,47,2015
Tonga,Tonga,Free,2,2,11,14,6,31,13,8,11,12,44,75,2015
Transnistria,Transnistria,Not Free,6,6,3,5,2,10,5,2,2,5,14,24,2015
Trinidad and Tobago,Trinidad and Tobago,Free,2,2,11,13,9,33,15,11,9,13,48,81,2015
Tunisia,Tunisia,Free,1,3,12,16,8,36,13,10,9,11,43,79,2015
Turkey,Turkey,Partly Free,3,4,10,10,6,26,8,5,7,9,29,55,2015
Turkmenistan,Turkmenistan,Not Free,7,7,0,1,0,1,2,0,0,3,5,6,2015
Tuvalu,Tuvalu,Free,1,1,12,15,10,37,16,12,15,14,57,94,2015
Uganda,Uganda,Not Free,6,5,3,5,3,11,9,4,5,7,25,36,2015
Ukraine,Ukraine,Partly Free,3,3,9,10,6,25,11,9,6,11,37,62,2015
United Arab Emirates,United Arab Emirates,Not Free,6,6,1,2,2,8,4,2,3,4,13,21,2015
United Kingdom,United Kingdom,Free,1,1,12,16,12,40,15,12,15,15,57,97,2015
United States,United States,Free,1,1,11,16,10,37,15,11,14,15,55,92,2015
Uruguay,Uruguay,Free,1,1,12,16,12,40,16,12,15,15,58,98,2015
Uzbekistan,Uzbekistan,Not Free,7,7,0,0,0,0,1,0,0,3,4,4,2015
Vanuatu,Vanuatu,Free,2,2,9,15,8,32,15,11,10,11,47,79,2015
Venezuela,Venezuela,Partly Free,5,5,5,6,2,13,8,3,3,8,22,35,2015
Vietnam,Vietnam,Not Free,7,5,0,1,2,3,4,1,4,8,17,20,2015
West Bank,West Bank,Not Free,6,5,2,5,2,6,9,6,5,5,25,31,2015
Western Sahara,Western Sahara,Not Free,7,7,0,0,0,-2,3,0,0,4,7,5,2015
Yemen,Yemen,Not Free,6,6,3,4,2,9,6,3,2,5,16,25,2015
Zambia,Zambia,Partly Free,3,4,8,12,6,26,11,7,8,8,34,60,2015
Zimbabwe,Zimbabwe,Not Free,5,6,3,6,3,12,6,3,2,5,16,28,2015
Abkhazia,Abkhazia,Partly Free,4,5,7,7,4,18,8,5,4,5,22,40,2014
Afghanistan,Afghanistan,Not Free,6,6,3,6,2,11,6,4,2,3,15,26,2014
Albania,Albania,Partly Free,3,3,8,13,6,27,13,9,9,9,40,67,2014
Algeria,Algeria,Not Free,6,5,4,4,3,11,6,5,5,7,23,34,2014
Andorra,Andorra,Free,1,1,12,15,12,39,16,11,15,15,57,96,2014
Angola,Angola,Not Free,6,5,4,6,1,11,7,4,4,3,18,29,2014
Antigua and Barbuda,Antigua and Barbuda,Free,2,2,11,13,7,31,14,9,13,13,49,80,2014
Argentina,Argentina,Free,2,2,11,14,6,31,14,11,11,13,49,80,2014
Armenia,Armenia,Partly Free,5,4,5,6,3,14,8,6,6,9,29,43,2014
Australia,Australia,Free,1,1,12,15,12,39,16,12,15,15,58,97,2014
Austria,Austria,Free,1,1,12,15,11,38,16,12,15,15,58,96,2014
Azerbaijan,Azerbaijan,Not Free,6,6,1,3,2,6,4,2,4,6,16,22,2014
Bahamas,Bahamas,Free,1,1,12,16,10,38,16,12,15,15,58,96,2014
Bahrain,Bahrain,Not Free,6,6,3,2,3,6,2,1,1,6,10,16,2014
Bangladesh,Bangladesh,Partly Free,3,4,9,10,5,24,8,6,6,9,29,53,2014
Barbados,Barbados,Free,1,1,12,16,12,40,16,12,16,15,59,99,2014
Belarus,Belarus,Not Free,7,6,0,3,1,4,3,1,1,5,10,14,2014
Belgium,Belgium,Free,1,1,12,16,12,40,15,12,15,15,57,97,2014
Belize,Belize,Free,1,2,12,14,10,36,15,11,12,13,51,87,2014
Benin,Benin,Free,2,2,8,16,8,32,15,11,12,10,48,80,2014
Bhutan,Bhutan,Partly Free,3,4,10,10,9,28,9,4,6,8,27,55,2014
Bolivia,Bolivia,Partly Free,3,3,11,11,7,29,14,9,6,9,38,67,2014
Bosnia and Herzegovina,Bosnia and Herzegovina,Partly Free,3,3,8,10,6,24,10,7,10,10,37,61,2014
Botswana,Botswana,Free,3,2,10,10,8,28,13,10,12,11,46,74,2014
Brazil,Brazil,Free,2,2,11,14,8,33,15,10,10,13,48,81,2014
Brunei,Brunei,Not Free,6,5,0,3,3,7,6,3,6,8,23,30,2014
Bulgaria,Bulgaria,Free,2,2,10,14,7,31,14,11,11,11,47,78,2014
Burkina Faso,Burkina Faso,Partly Free,5,3,5,8,4,17,13,8,7,8,36,53,2014
Burundi,Burundi,Partly Free,5,5,4,6,2,12,8,4,4,6,22,34,2014
Cape Verde,Cabo Verde,Free,1,1,12,15,10,37,15,11,14,13,53,90,2014
Cambodia,Cambodia,Not Free,6,5,3,4,3,10,9,3,2,6,20,30,2014
Cameroon,Cameroon,Not Free,6,6,3,3,2,8,7,3,2,4,16,24,2014
Canada,Canada,Free,1,1,12,16,11,39,16,12,15,16,59,98,2014
Central African Republic,Central African Republic,Not Free,7,7,0,1,0,0,4,1,0,1,6,6,2014
Chad,Chad,Not Free,7,6,3,1,1,5,7,4,2,3,16,21,2014
Chile,Chile,Free,1,1,12,15,12,39,16,11,14,15,56,95,2014
China,China,Not Free,7,6,0,1,2,2,4,3,2,6,15,17,2014
Colombia,Colombia,Partly Free,3,4,10,11,7,28,12,5,7,10,34,62,2014
Comoros,Comoros,Partly Free,3,4,9,11,5,25,10,6,8,6,30,55,2014
Congo,Congo (Brazzaville),Not Free,6,5,1,3,3,7,8,6,2,7,23,30,2014
DR Congo,Congo (Kinshasa),Not Free,6,6,3,4,2,9,7,3,0,1,11,20,2014
Costa Rica,Costa Rica,Free,1,1,12,15,10,37,16,11,13,13,53,90,2014
Cote d'Ivoire,Cote d'Ivoire,Partly Free,5,4,6,7,4,17,10,7,5,6,28,45,2014
Croatia,Croatia,Free,1,2,12,15,9,36,14,12,11,13,50,86,2014
Cuba,Cuba,Not Free,7,6,0,0,1,1,3,0,2,6,11,12,2014
Cyprus,Cyprus,Free,1,1,11,16,10,37,15,11,15,14,55,92,2014
Czech Republic,Czech Republic,Free,1,1,12,15,10,37,16,12,14,15,57,94,2014
Denmark,Denmark,Free,1,1,12,16,12,40,16,12,15,15,58,98,2014
Djibouti,Djibouti,Not Free,6,5,3,3,3,9,7,3,4,6,20,29,2014
Dominica,Dominica,Free,1,1,12,16,10,38,15,12,15,15,57,95,2014
Dominican Republic,Dominican Republic,Free,2,3,10,11,9,30,15,10,8,10,43,73,2014
Ecuador,Ecuador,Partly Free,3,3,7,11,6,24,13,7,6,10,36,60,2014
Egypt,Egypt,Not Free,6,5,1,6,2,9,6,4,4,8,22,31,2014
El Salvador,El Salvador,Free,2,3,12,14,9,35,15,8,9,10,42,77,2014
Equatorial Guinea,Equatorial Guinea,Not Free,7,7,0,1,0,1,4,0,0,3,7,8,2014
Eritrea,Eritrea,Not Free,7,7,0,0,1,1,0,0,0,2,2,3,2014
Estonia,Estonia,Free,1,1,12,15,12,39,16,12,14,14,56,95,2014
Eswatini,Eswatini,Not Free,7,5,0,1,0,1,8,2,5,4,19,20,2014
Ethiopia,Ethiopia,Not Free,6,6,1,2,4,7,3,0,3,5,11,18,2014
Fiji,Fiji,Partly Free,6,4,0,5,2,7,11,3,6,10,30,37,2014
Finland,Finland,Free,1,1,12,16,12,40,16,12,16,16,60,100,2014
France,France,Free,1,1,12,15,11,38,15,12,15,15,57,95,2014
Gabon,Gabon,Not Free,6,5,2,4,3,9,10,4,6,5,25,34,2014
Gaza Strip,Gaza Strip,Not Free,7,6,2,2,1,5,4,3,0,3,10,15,2014
Georgia,Georgia,Partly Free,3,3,8,10,7,25,12,8,8,10,38,63,2014
Germany,Germany,Free,1,1,12,15,12,39,15,12,15,15,57,96,2014
Ghana,Ghana,Free,1,2,12,15,10,37,14,11,12,10,47,84,2014
Greece,Greece,Free,2,2,12,15,8,35,14,11,10,13,48,83,2014
Grenada,Grenada,Free,1,2,12,16,10,38,15,11,12,13,51,89,2014
Guatemala,Guatemala,Partly Free,3,4,9,10,5,24,12,6,6,8,32,56,2014
Guinea,Guinea,Partly Free,5,5,6,8,3,17,9,6,4,5,24,41,2014
Guinea-Bissau,Guinea-Bissau,Not Free,6,5,3,5,1,9,10,5,3,5,23,32,2014
Guyana,Guyana,Free,2,3,11,13,7,31,15,10,7,9,41,72,2014
Haiti,Haiti,Partly Free,4,5,4,9,5,18,10,5,4,6,25,43,2014
Honduras,Honduras,Partly Free,4,4,7,9,4,20,11,6,5,9,31,51,2014
Hong Kong,Hong Kong,Partly Free,5,2,3,7,6,16,14,9,15,13,51,67,2014
Hungary,Hungary,Free,1,2,12,15,9,36,15,12,11,14,52,88,2014
Iceland,Iceland,Free,1,1,12,16,12,40,16,12,16,16,60,100,2014
India,India,Free,2,3,11,14,9,34,13,11,9,10,43,77,2014
Indian Kashmir,Indian Kashmir,Partly Free,4,4,8,8,4,20,9,6,6,8,29,49,2014
Indonesia,Indonesia,Partly Free,2,4,11,13,6,30,12,8,5,9,34,64,2014
Iran,Iran,Not Free,6,6,3,2,2,7,2,1,3,4,10,17,2014
Iraq,Iraq,Not Free,5,6,7,5,1,12,5,4,0,4,13,25,2014
Ireland,Ireland,Free,1,1,12,16,11,39,16,12,15,15,58,97,2014
Israel,Israel,Free,1,2,12,14,10,36,12,11,11,11,45,81,2014
Italy,Italy,Free,1,1,12,15,10,37,15,12,12,14,53,90,2014
Jamaica,Jamaica,Free,2,3,12,13,9,34,15,9,6,10,40,74,2014
Japan,Japan,Free,1,1,12,15,10,37,14,11,15,13,53,90,2014
Jordan,Jordan,Not Free,6,5,2,6,3,11,7,3,6,8,24,35,2014
Kazakhstan,Kazakhstan,Not Free,6,5,2,3,1,6,4,3,4,8,19,25,2014
Kenya,Kenya,Partly Free,4,4,7,10,5,22,11,7,6,7,31,53,2014
Kiribati,Kiribati,Free,1,1,12,16,8,36,15,12,15,13,55,91,2014
Kosovo,Kosovo,Partly Free,5,4,6,9,3,17,8,6,5,7,26,43,2014
Kuwait,Kuwait,Partly Free,5,5,2,9,5,16,6,4,7,6,23,39,2014
Kyrgyzstan,Kyrgyzstan,Partly Free,5,5,6,6,4,14,9,5,4,7,25,39,2014
Laos,Laos,Not Free,7,6,0,0,1,1,4,0,2,5,11,12,2014
Latvia,Latvia,Free,2,2,12,14,7,33,15,12,12,12,51,84,2014
Lebanon,Lebanon,Partly Free,5,4,4,9,3,16,11,7,5,9,32,48,2014
Lesotho,Lesotho,Free,2,3,10,13,8,31,14,7,11,9,41,72,2014
Liberia,Liberia,Partly Free,3,4,9,11,6,26,10,8,7,8,33,59,2014
Libya,Libya,Partly Free,4,5,9,9,3,21,8,5,1,6,20,41,2014
Liechtenstein,Liechtenstein,Free,1,1,12,15,12,39,16,12,15,16,59,98,2014
Lithuania,Lithuania,Free,1,1,12,16,9,37,16,11,13,13,53,90,2014
Luxembourg,Luxembourg,Free,1,1,12,16,11,39,16,12,16,16,60,99,2014
Madagascar,Madagascar,Partly Free,5,4,6,8,1,15,9,7,5,7,28,43,2014
Malawi,Malawi,Partly Free,3,4,8,11,7,26,11,7,9,7,34,60,2014
Malaysia,Malaysia,Partly Free,4,4,6,7,6,19,8,6,5,9,28,47,2014
Maldives,Maldives,Partly Free,4,4,7,7,5,19,7,7,7,8,29,48,2014
Mali,Mali,Partly Free,5,4,6,7,4,17,11,6,6,4,27,44,2014
Malta,Malta,Free,1,1,12,16,11,39,16,12,15,15,58,97,2014
Marshall Islands,Marshall Islands,Free,1,1,11,15,10,36,16,11,15,13,55,91,2014
Mauritania,Mauritania,Not Free,6,5,3,3,5,11,10,4,4,5,23,34,2014
Mauritius,Mauritius,Free,1,2,12,15,11,38,15,12,13,12,52,90,2014
Mexico,Mexico,Partly Free,3,3,9,12,7,28,13,8,6,10,37,65,2014
Micronesia,Micronesia,Free,1,1,12,15,10,37,16,11,15,14,56,93,2014
Moldova,Moldova,Partly Free,3,3,11,12,6,29,11,8,7,9,35,64,2014
Monaco,Monaco,Free,2,1,10,11,10,31,16,12,15,14,57,88,2014
Mongolia,Mongolia,Free,1,2,11,16,9,36,15,11,12,12,50,86,2014
Montenegro,Montenegro,Free,3,2,9,11,7,27,13,10,10,12,45,72,2014
Morocco,Morocco,Partly Free,5,4,5,7,3,15,8,6,6,7,27,42,2014
Mozambique,Mozambique,Partly Free,4,3,6,10,7,23,12,7,7,9,35,58,2014
Myanmar,Myanmar,Not Free,6,5,3,6,3,9,7,4,1,5,17,26,2014
Nagorno-Karabakh,Nagorno-Karabakh,Partly Free,5,5,4,5,3,12,6,3,5,5,19,31,2014
Namibia,Namibia,Free,2,2,10,11,9,30,14,12,11,9,46,76,2014
Nauru,Nauru,Free,1,1,12,16,10,38,15,11,14,14,54,92,2014
Nepal,Nepal,Partly Free,4,4,8,11,4,23,9,6,5,7,27,50,2014
Netherlands,Netherlands,Free,1,1,12,16,12,40,16,12,15,16,59,99,2014
New Zealand,New Zealand,Free,1,1,12,15,12,39,16,12,15,15,58,97,2014
Nicaragua,Nicaragua,Partly Free,4,3,6,7,6,19,12,6,7,10,35,54,2014
Niger,Niger,Partly Free,3,4,9,10,7,26,11,8,5,6,30,56,2014
Nigeria,Nigeria,Partly Free,4,4,6,9,5,20,9,7,4,6,26,46,2014
North Korea,North Korea,Not Free,7,7,0,0,0,0,0,0,0,3,3,3,2014
Macedonia,North Macedonia,Partly Free,3,3,8,11,7,26,11,8,8,11,38,64,2014
Northern Cyprus,Northern Cyprus,Free,2,2,11,12,9,32,14,9,12,12,47,79,2014
Norway,Norway,Free,1,1,12,16,12,40,16,12,16,16,60,100,2014
Oman,Oman,Not Free,6,5,2,2,2,9,5,3,4,5,17,26,2014
Pakistan,Pakistan,Partly Free,4,5,7,9,5,21,5,6,4,6,21,42,2014
Pakistani Kashmir,Pakistani Kashmir,Not Free,6,5,3,4,3,8,6,5,4,6,21,29,2014
Palau,Palau,Free,1,1,12,15,10,37,16,11,15,13,55,92,2014
Panama,Panama,Free,2,2,12,15,8,35,15,11,9,12,47,82,2014
Papua New Guinea,Papua New Guinea,Partly Free,3,3,9,10,5,24,12,9,7,8,36,60,2014
Paraguay,Paraguay,Partly Free,3,3,10,12,4,26,12,8,5,10,35,61,2014
Peru,Peru,Free,2,3,10,13,7,30,15,8,8,10,41,71,2014
Philippines,Philippines,Partly Free,3,3,9,10,7,26,14,8,5,10,37,63,2014
Poland,Poland,Free,1,1,12,16,10,38,16,12,13,14,55,93,2014
Portugal,Portugal,Free,1,1,12,16,11,39,16,12,15,15,58,97,2014
Puerto Rico,Puerto Rico,Free,1,2,12,15,10,37,16,10,12,14,52,89,2014
Qatar,Qatar,Not Free,6,5,2,2,3,10,8,2,4,4,18,28,2014
Romania,Romania,Free,2,2,12,14,9,35,14,11,12,12,49,84,2014
Russia,Russia,Not Free,6,5,1,3,3,7,6,4,2,7,19,26,2014
Rwanda,Rwanda,Not Free,6,5,2,2,5,9,5,2,3,7,17,26,2014
Samoa,Samoa,Free,2,2,9,13,10,32,14,10,13,12,49,81,2014
San Marino,San Marino,Free,1,1,12,16,12,40,16,12,16,16,60,100,2014
Sao Tome and Principe,Sao Tome and Principe,Free,2,2,11,14,9,34,15,10,12,10,47,81,2014
Saudi Arabia,Saudi Arabia,Not Free,7,7,0,0,1,3,3,0,2,2,7,10,2014
Senegal,Senegal,Free,2,2,11,13,9,33,15,11,10,10,46,79,2014
Serbia,Serbia,Free,2,2,9,14,7,30,15,10,10,13,48,78,2014
Seychelles,Seychelles,Partly Free,3,3,8,10,7,25,11,9,11,11,42,67,2014
Sierra Leone,Sierra Leone,Partly Free,3,3,10,12,7,29,12,7,9,10,38,67,2014
Singapore,Singapore,Partly Free,4,4,4,8,7,19,9,4,7,12,32,51,2014
Slovakia,Slovakia,Free,1,1,12,15,10,37,16,12,12,14,54,91,2014
Slovenia,Slovenia,Free,1,1,12,15,11,38,14,12,14,13,53,91,2014
Solomon Islands,Solomon Islands,Partly Free,4,3,6,10,6,22,14,9,8,12,43,65,2014
Somalia,Somalia,Not Free,7,7,0,0,0,0,1,0,0,1,2,2,2014
Somaliland,Somaliland,Partly Free,4,5,5,10,6,21,7,5,7,6,25,46,2014
South Africa,South Africa,Free,2,2,12,13,8,33,15,12,10,11,48,81,2014
South Korea,South Korea,Free,2,2,11,14,10,35,14,11,13,12,50,85,2014
South Ossetia,South Ossetia,Not Free,7,6,0,0,0,-3,4,0,1,3,8,5,2014
South Sudan,South Sudan,Not Free,6,6,4,2,2,8,7,3,1,5,16,24,2014
Spain,Spain,Free,1,1,12,16,11,39,15,12,15,15,57,96,2014
Sri Lanka,Sri Lanka,Partly Free,5,4,6,6,4,16,7,6,5,8,26,42,2014
St. Kitts and Nevis,St. Kitts and Nevis,Free,1,1,12,16,9,37,15,12,13,13,53,90,2014
St. Lucia,St. Lucia,Free,1,1,12,16,11,39,15,12,12,14,53,92,2014
St. Vincent and the Grenadines,St. Vincent and the Grenadines,Free,1,1,11,16,9,36,15,12,12,14,53,89,2014
Sudan,Sudan,Not Free,7,7,2,3,1,2,3,1,0,1,5,7,2014
Suriname,Suriname,Free,2,2,12,13,8,33,15,11,8,10,44,77,2014
Sweden,Sweden,Free,1,1,12,16,12,40,16,12,15,16,59,99,2014
Switzerland,Switzerland,Free,1,1,12,15,12,39,15,12,15,15,57,96,2014
Syria,Syria,Not Free,7,7,0,0,0,-2,1,0,0,2,3,1,2014
Taiwan,Taiwan,Free,1,2,11,15,10,36,14,11,14,13,52,88,2014
Tajikistan,Tajikistan,Not Free,6,6,2,4,2,8,5,4,3,4,16,24,2014
Tanzania,Tanzania,Partly Free,3,3,9,12,8,29,10,7,9,9,35,64,2014
Thailand,Thailand,Partly Free,4,4,8,9,5,22,10,6,6,10,32,54,2014
Gambia,The Gambia,Not Free,6,6,2,5,0,7,4,3,1,6,14,21,2014
Tibet,Tibet,Not Free,7,7,0,0,1,-2,0,0,0,3,3,1,2014
Timor-Leste,Timor-Leste,Partly Free,3,4,11,12,6,29,12,7,6,9,34,63,2014
Togo,Togo,Partly Free,4,4,5,8,5,18,9,6,7,7,29,47,2014
Tonga,Tonga,Free,2,2,11,14,6,31,13,8,11,12,44,75,2014
Transnistria,Transnistria,Not Free,6,6,3,5,2,10,5,2,2,5,14,24,2014
Trinidad and Tobago,Trinidad and Tobago,Free,2,2,11,13,9,33,15,11,9,13,48,81,2014
Tunisia,Tunisia,Partly Free,3,3,9,12,6,27,11,9,6,10,36,63,2014
Turkey,Turkey,Partly Free,3,4,11,10,7,28,9,6,8,9,32,60,2014
Turkmenistan,Turkmenistan,Not Free,7,7,0,1,0,1,2,0,1,3,6,7,2014
Tuvalu,Tuvalu,Free,1,1,12,15,10,37,16,12,15,14,57,94,2014
Uganda,Uganda,Partly Free,6,4,3,5,3,11,10,4,5,7,26,37,2014
Ukraine,Ukraine,Partly Free,4,3,8,8,4,20,9,8,7,11,35,55,2014
United Arab Emirates,United Arab Emirates,Not Free,6,6,1,2,2,8,4,2,3,4,13,21,2014
United Kingdom,United Kingdom,Free,1,1,12,16,12,40,15,12,15,15,57,97,2014
United States,United States,Free,1,1,11,16,10,37,15,11,14,15,55,92,2014
Uruguay,Uruguay,Free,1,1,12,16,12,40,16,12,15,15,58,98,2014
Uzbekistan,Uzbekistan,Not Free,7,7,0,0,0,0,1,0,0,3,4,4,2014
Vanuatu,Vanuatu,Free,2,2,9,15,8,32,15,11,10,11,47,79,2014
Venezuela,Venezuela,Partly Free,5,5,5,7,2,14,8,4,4,8,24,38,2014
Vietnam,Vietnam,Not Free,7,5,0,1,2,3,4,1,4,8,17,20,2014
West Bank,West Bank,Not Free,6,5,2,5,2,7,8,6,5,5,24,31,2014
Western Sahara,Western Sahara,Not Free,7,7,0,0,0,-2,3,0,0,4,7,5,2014
Yemen,Yemen,Not Free,6,6,3,4,3,10,6,3,2,5,16,26,2014
Zambia,Zambia,Partly Free,3,4,8,10,7,25,11,7,8,8,34,59,2014
Zimbabwe,Zimbabwe,Not Free,5,6,3,6,3,12,6,3,2,5,16,28,2014
Abkhazia,Abkhazia,Partly Free,4,5,7,7,4,18,8,5,4,5,22,40,2013
Afghanistan,Afghanistan,Not Free,6,6,3,6,2,11,6,5,2,3,16,27,2013
Albania,Albania,Partly Free,3,3,8,10,6,24,13,8,9,9,39,63,2013
Algeria,Algeria,Not Free,6,5,4,4,3,11,7,5,5,7,24,35,2013
Andorra,Andorra,Free,1,1,12,15,12,39,16,11,15,15,57,96,2013
Angola,Angola,Not Free,6,5,4,6,1,11,8,4,4,3,19,30,2013
Antigua and Barbuda,Antigua and Barbuda,Free,2,2,11,13,7,31,14,9,13,13,49,80,2013
Argentina,Argentina,Free,2,2,11,14,6,31,14,11,11,13,49,80,2013
Armenia,Armenia,Partly Free,5,4,5,5,3,13,8,6,6,9,29,42,2013
Australia,Australia,Free,1,1,12,15,12,39,16,12,15,15,58,97,2013
Austria,Austria,Free,1,1,12,15,11,38,16,12,15,15,58,96,2013
Azerbaijan,Azerbaijan,Not Free,6,5,1,3,2,6,4,2,4,7,17,23,2013
Bahamas,Bahamas,Free,1,1,12,16,10,38,16,12,15,15,58,96,2013
Bahrain,Bahrain,Not Free,6,6,3,2,3,6,3,2,1,6,12,18,2013
Bangladesh,Bangladesh,Partly Free,3,4,9,11,5,25,9,7,6,9,31,56,2013
Barbados,Barbados,Free,1,1,12,16,12,40,16,12,16,15,59,99,2013
Belarus,Belarus,Not Free,7,6,0,3,1,4,3,1,1,5,10,14,2013
Belgium,Belgium,Free,1,1,12,16,12,40,15,12,15,15,57,97,2013
Belize,Belize,Free,1,2,12,14,11,37,15,11,12,13,51,88,2013
Benin,Benin,Free,2,2,8,16,8,32,15,12,13,10,50,82,2013
Bhutan,Bhutan,Partly Free,4,5,8,8,7,22,8,3,5,8,24,46,2013
Bolivia,Bolivia,Partly Free,3,3,11,11,7,29,14,10,7,9,40,69,2013
Bosnia and Herzegovina,Bosnia and Herzegovina,Partly Free,3,3,8,11,6,25,10,7,10,10,37,62,2013
Botswana,Botswana,Free,3,2,10,10,8,28,13,10,12,11,46,74,2013
Brazil,Brazil,Free,2,2,11,14,8,33,15,10,10,13,48,81,2013
Brunei,Brunei,Not Free,6,5,0,3,3,7,6,3,6,8,23,30,2013
Bulgaria,Bulgaria,Free,2,2,11,15,8,34,14,11,11,11,47,81,2013
Burkina Faso,Burkina Faso,Partly Free,5,3,5,8,4,17,13,8,7,8,36,53,2013
Burundi,Burundi,Partly Free,5,5,4,6,2,12,8,4,4,6,22,34,2013
Cape Verde,Cabo Verde,Free,1,1,12,15,10,37,15,11,14,13,53,90,2013
Cambodia,Cambodia,Not Free,6,5,3,3,3,9,9,3,2,6,20,29,2013
Cameroon,Cameroon,Not Free,6,6,2,3,2,7,7,3,2,4,16,23,2013
Canada,Canada,Free,1,1,12,16,12,40,16,11,15,16,58,98,2013
Central African Republic,Central African Republic,Partly Free,5,5,7,7,2,16,8,4,3,4,19,35,2013
Chad,Chad,Not Free,7,6,3,1,1,5,7,4,2,3,16,21,2013
Chile,Chile,Free,1,1,12,15,12,39,16,11,15,15,57,96,2013
China,China,Not Free,7,6,0,1,2,2,4,3,2,6,15,17,2013
Colombia,Colombia,Partly Free,3,4,10,10,7,27,12,5,7,10,34,61,2013
Comoros,Comoros,Partly Free,3,4,9,11,5,25,10,6,8,6,30,55,2013
Congo,Congo (Brazzaville),Not Free,6,5,1,3,3,7,8,6,2,6,22,29,2013
DR Congo,Congo (Kinshasa),Not Free,6,6,3,4,2,9,7,3,0,1,11,20,2013
Costa Rica,Costa Rica,Free,1,1,12,15,11,38,16,11,13,13,53,91,2013
Cote d'Ivoire,Cote d'Ivoire,Partly Free,5,5,5,4,4,13,8,5,4,4,21,34,2013
Croatia,Croatia,Free,1,2,12,15,9,36,14,12,11,13,50,86,2013
Cuba,Cuba,Not Free,7,6,0,0,1,1,2,0,2,6,10,11,2013
Cyprus,Cyprus,Free,1,1,11,16,11,38,15,11,15,14,55,93,2013
Czech Republic,Czech Republic,Free,1,1,12,15,11,38,16,12,14,15,57,95,2013
Denmark,Denmark,Free,1,1,12,16,12,40,16,12,15,15,58,98,2013
Djibouti,Djibouti,Not Free,6,5,3,3,3,9,7,3,4,6,20,29,2013
Dominica,Dominica,Free,1,1,12,16,10,38,15,12,15,15,57,95,2013
Dominican Republic,Dominican Republic,Free,2,2,10,12,9,31,15,10,8,11,44,75,2013
Ecuador,Ecuador,Partly Free,3,3,7,11,6,24,13,7,6,10,36,60,2013
Egypt,Egypt,Partly Free,5,5,3,10,3,16,8,5,4,8,25,41,2013
El Salvador,El Salvador,Free,2,3,12,14,9,35,15,8,9,10,42,77,2013
Equatorial Guinea,Equatorial Guinea,Not Free,7,7,0,1,0,1,4,0,0,3,7,8,2013
Eritrea,Eritrea,Not Free,7,7,0,0,1,1,0,0,0,2,2,3,2013
Estonia,Estonia,Free,1,1,12,15,12,39,16,12,14,14,56,95,2013
Eswatini,Eswatini,Not Free,7,5,0,1,0,1,8,3,5,4,20,21,2013
Ethiopia,Ethiopia,Not Free,6,6,1,2,4,7,3,0,3,5,11,18,2013
Fiji,Fiji,Partly Free,6,4,0,5,2,7,11,3,6,10,30,37,2013
Finland,Finland,Free,1,1,12,16,12,40,16,12,16,16,60,100,2013
France,France,Free,1,1,12,15,11,38,15,12,15,15,57,95,2013
Gabon,Gabon,Not Free,6,5,2,4,3,9,10,4,6,5,25,34,2013
Gaza Strip,Gaza Strip,Not Free,6,6,5,2,2,9,4,3,0,3,10,19,2013
Georgia,Georgia,Partly Free,3,3,7,10,7,24,12,7,7,10,36,60,2013
Germany,Germany,Free,1,1,12,15,12,39,15,12,15,15,57,96,2013
Ghana,Ghana,Free,1,2,12,15,10,37,14,11,12,10,47,84,2013
Greece,Greece,Free,2,2,12,15,8,35,14,11,10,13,48,83,2013
Grenada,Grenada,Free,1,2,12,16,10,38,15,11,12,13,51,89,2013
Guatemala,Guatemala,Partly Free,3,4,9,10,5,24,12,7,6,8,33,57,2013
Guinea,Guinea,Partly Free,5,5,5,8,2,15,9,6,4,5,24,39,2013
Guinea-Bissau,Guinea-Bissau,Not Free,6,5,2,5,0,7,10,5,3,5,23,30,2013
Guyana,Guyana,Free,2,3,11,13,7,31,15,9,7,9,40,71,2013
Haiti,Haiti,Partly Free,4,5,5,9,5,19,10,5,4,5,24,43,2013
Honduras,Honduras,Partly Free,4,4,6,8,4,18,11,6,7,9,33,51,2013
Hong Kong,Hong Kong,Partly Free,5,2,3,7,6,16,14,9,15,13,51,67,2013
Hungary,Hungary,Free,1,2,12,15,9,36,15,12,11,14,52,88,2013
Iceland,Iceland,Free,1,1,12,16,12,40,16,12,16,16,60,100,2013
India,India,Free,2,3,11,14,9,34,13,11,8,10,42,76,2013
Indian Kashmir,Indian Kashmir,Partly Free,4,4,8,8,4,20,9,6,6,8,29,49,2013
Indonesia,Indonesia,Free,2,3,11,13,6,30,12,9,5,9,35,65,2013
Iran,Iran,Not Free,6,6,2,2,2,6,2,1,3,4,10,16,2013
Iraq,Iraq,Not Free,6,6,7,4,1,11,5,4,0,4,13,24,2013
Ireland,Ireland,Free,1,1,12,16,11,39,16,12,15,15,58,97,2013
Israel,Israel,Free,1,2,12,14,10,36,12,11,11,11,45,81,2013
Italy,Italy,Free,2,1,11,15,9,35,15,12,12,14,53,88,2013
Jamaica,Jamaica,Free,2,3,12,13,8,33,15,9,6,10,40,73,2013
Japan,Japan,Free,1,2,12,15,10,37,13,10,15,13,51,88,2013
Jordan,Jordan,Not Free,6,5,2,5,3,10,7,3,6,8,24,34,2013
Kazakhstan,Kazakhstan,Not Free,6,5,2,3,1,6,5,3,4,8,20,26,2013
Kenya,Kenya,Partly Free,4,4,6,10,5,21,13,8,6,7,34,55,2013
Kiribati,Kiribati,Free,1,1,12,16,8,36,15,12,15,13,55,91,2013
Kosovo,Kosovo,Partly Free,5,4,6,8,3,16,8,6,5,7,26,42,2013
Kuwait,Kuwait,Partly Free,5,5,2,10,5,17,7,4,7,6,24,41,2013
Kyrgyzstan,Kyrgyzstan,Partly Free,5,5,6,6,4,14,9,5,4,7,25,39,2013
Laos,Laos,Not Free,7,6,0,0,0,0,4,0,2,5,11,11,2013
Latvia,Latvia,Free,2,2,12,14,7,33,15,12,12,12,51,84,2013
Lebanon,Lebanon,Partly Free,5,4,5,9,3,17,11,7,5,9,32,49,2013
Lesotho,Lesotho,Free,2,3,10,13,8,31,14,7,11,9,41,72,2013
Liberia,Liberia,Partly Free,3,4,9,11,6,26,11,8,7,8,34,60,2013
Libya,Libya,Partly Free,4,5,9,10,3,22,8,6,1,6,21,43,2013
Liechtenstein,Liechtenstein,Free,1,1,12,15,12,39,16,12,15,16,59,98,2013
Lithuania,Lithuania,Free,1,1,12,16,9,37,16,11,13,13,53,90,2013
Luxembourg,Luxembourg,Free,1,1,12,16,12,40,16,12,16,16,60,100,2013
Madagascar,Madagascar,Partly Free,6,4,1,5,1,7,9,7,5,7,28,35,2013
Malawi,Malawi,Partly Free,3,4,8,11,7,26,11,7,9,7,34,60,2013
Malaysia,Malaysia,Partly Free,4,4,6,8,6,20,9,5,5,9,28,48,2013
Maldives,Maldives,Partly Free,5,4,7,6,4,17,7,7,7,8,29,46,2013
Mali,Mali,Not Free,7,5,1,3,2,5,8,4,3,4,19,24,2013
Malta,Malta,Free,1,1,12,16,11,39,16,12,15,15,58,97,2013
Marshall Islands,Marshall Islands,Free,1,1,11,15,10,36,16,11,15,13,55,91,2013
Mauritania,Mauritania,Not Free,6,5,3,3,5,11,10,4,4,5,23,34,2013
Mauritius,Mauritius,Free,1,2,12,15,11,38,15,12,13,12,52,90,2013
Mexico,Mexico,Partly Free,3,3,9,12,7,28,13,8,6,10,37,65,2013
Micronesia,Micronesia,Free,1,1,12,15,10,37,16,11,15,14,56,93,2013
Moldova,Moldova,Partly Free,3,3,11,12,6,29,11,8,8,9,36,65,2013
Monaco,Monaco,Free,2,1,10,11,10,31,15,12,15,14,56,87,2013
Mongolia,Mongolia,Free,1,2,11,16,9,36,15,11,12,12,50,86,2013
Montenegro,Montenegro,Free,3,2,9,11,7,27,13,10,10,12,45,72,2013
Morocco,Morocco,Partly Free,5,4,5,7,4,16,8,6,6,7,27,43,2013
Mozambique,Mozambique,Partly Free,4,3,6,10,7,23,12,7,8,9,36,59,2013
Myanmar,Myanmar,Not Free,6,5,3,6,3,9,7,4,1,5,17,26,2013
Nagorno-Karabakh,Nagorno-Karabakh,Partly Free,5,5,4,5,3,12,6,3,5,5,19,31,2013
Namibia,Namibia,Free,2,2,10,11,9,30,14,12,11,9,46,76,2013
Nauru,Nauru,Free,1,1,12,16,10,38,15,11,15,14,55,93,2013
Nepal,Nepal,Partly Free,4,4,5,11,4,20,9,6,5,7,27,47,2013
Netherlands,Netherlands,Free,1,1,12,16,12,40,16,12,15,16,59,99,2013
New Zealand,New Zealand,Free,1,1,12,15,12,39,16,12,15,15,58,97,2013
Nicaragua,Nicaragua,Partly Free,5,4,6,7,4,17,12,6,7,9,34,51,2013
Niger,Niger,Partly Free,3,4,9,10,7,26,11,8,5,6,30,56,2013
Nigeria,Nigeria,Partly Free,4,4,6,9,5,20,9,7,4,6,26,46,2013
North Korea,North Korea,Not Free,7,7,0,0,0,0,0,0,0,3,3,3,2013
Macedonia,North Macedonia,Partly Free,3,3,8,11,7,26,11,8,8,11,38,64,2013
Northern Cyprus,Northern Cyprus,Free,2,2,11,12,9,32,13,9,12,12,46,78,2013
Norway,Norway,Free,1,1,12,16,12,40,16,12,16,16,60,100,2013
Oman,Oman,Not Free,6,5,2,2,2,9,5,3,4,5,17,26,2013
Pakistan,Pakistan,Partly Free,4,5,6,9,5,20,5,7,4,6,22,42,2013
Pakistani Kashmir,Pakistani Kashmir,Not Free,6,5,3,4,3,8,6,5,4,6,21,29,2013
Palau,Palau,Free,1,1,12,15,10,37,16,11,15,13,55,92,2013
Panama,Panama,Free,1,2,12,15,9,36,15,10,9,12,46,82,2013
Papua New Guinea,Papua New Guinea,Partly Free,4,3,9,10,4,23,12,9,7,8,36,59,2013
Paraguay,Paraguay,Partly Free,3,3,10,12,5,27,11,8,6,10,35,62,2013
Peru,Peru,Free,2,3,10,13,7,30,15,8,8,10,41,71,2013
Philippines,Philippines,Partly Free,3,3,9,10,7,26,14,8,5,10,37,63,2013
Poland,Poland,Free,1,1,12,16,10,38,16,12,13,14,55,93,2013
Portugal,Portugal,Free,1,1,12,16,11,39,16,12,15,15,58,97,2013
Puerto Rico,Puerto Rico,Free,1,2,12,15,10,37,16,10,12,14,52,89,2013
Qatar,Qatar,Not Free,6,5,2,2,3,10,8,2,4,4,18,28,2013
Romania,Romania,Free,2,2,10,14,8,32,14,11,12,12,49,81,2013
Russia,Russia,Not Free,6,5,1,3,3,7,6,4,3,7,20,27,2013
Rwanda,Rwanda,Not Free,6,6,2,2,4,8,4,2,3,7,16,24,2013
Samoa,Samoa,Free,2,2,9,13,10,32,14,10,13,12,49,81,2013
San Marino,San Marino,Free,1,1,12,16,12,40,16,12,16,16,60,100,2013
Sao Tome and Principe,Sao Tome and Principe,Free,2,2,11,14,9,34,15,10,12,10,47,81,2013
Saudi Arabia,Saudi Arabia,Not Free,7,7,0,0,1,3,3,0,2,2,7,10,2013
Senegal,Senegal,Free,2,3,11,13,8,32,14,10,10,9,43,75,2013
Serbia,Serbia,Free,2,2,9,14,7,30,15,10,10,13,48,78,2013
Seychelles,Seychelles,Partly Free,3,3,8,10,7,25,11,9,11,11,42,67,2013
Sierra Leone,Sierra Leone,Free,2,3,10,12,8,30,13,8,9,10,40,70,2013
Singapore,Singapore,Partly Free,4,4,4,8,7,19,10,4,7,12,33,52,2013
Slovakia,Slovakia,Free,1,1,12,15,10,37,16,12,13,14,55,92,2013
Slovenia,Slovenia,Free,1,1,12,15,11,38,14,12,14,13,53,91,2013
Solomon Islands,Solomon Islands,Partly Free,4,3,6,10,6,22,14,9,8,12,43,65,2013
Somalia,Somalia,Not Free,7,7,0,0,0,0,1,0,0,1,2,2,2013
Somaliland,Somaliland,Partly Free,4,5,5,10,6,21,7,5,7,6,25,46,2013
South Africa,South Africa,Free,2,2,12,14,8,34,15,11,10,11,47,81,2013
South Korea,South Korea,Free,1,2,11,15,10,36,14,11,13,12,50,86,2013
South Ossetia,South Ossetia,Not Free,7,6,0,0,0,-3,4,0,1,3,8,5,2013
South Sudan,South Sudan,Not Free,6,5,4,5,2,11,8,4,3,5,20,31,2013
Spain,Spain,Free,1,1,12,16,11,39,16,12,14,15,57,96,2013
Sri Lanka,Sri Lanka,Partly Free,5,4,6,6,4,16,8,6,5,8,27,43,2013
St. Kitts and Nevis,St. Kitts and Nevis,Free,1,1,12,16,10,38,15,12,12,14,53,91,2013
St. Lucia,St. Lucia,Free,1,1,12,16,11,39,16,12,12,14,54,93,2013
St. Vincent and the Grenadines,St. Vincent and the Grenadines,Free,1,1,11,16,9,36,15,11,13,14,53,89,2013
Sudan,Sudan,Not Free,7,7,2,3,1,2,3,1,0,1,5,7,2013
Suriname,Suriname,Free,2,2,12,13,8,33,15,11,8,10,44,77,2013
Sweden,Sweden,Free,1,1,12,16,12,40,16,12,16,16,60,100,2013
Switzerland,Switzerland,Free,1,1,12,15,12,39,15,12,15,15,57,96,2013
Syria,Syria,Not Free,7,7,0,0,1,-1,2,0,0,4,6,5,2013
Taiwan,Taiwan,Free,1,2,11,15,10,36,14,11,14,13,52,88,2013
Tajikistan,Tajikistan,Not Free,6,6,2,4,2,8,5,4,3,4,16,24,2013
Tanzania,Tanzania,Partly Free,3,3,9,12,7,28,11,7,11,9,38,66,2013
Thailand,Thailand,Partly Free,4,4,8,9,5,22,9,6,6,10,31,53,2013
Gambia,The Gambia,Not Free,6,6,2,5,0,7,5,4,1,6,16,23,2013
Tibet,Tibet,Not Free,7,7,0,0,1,-2,0,0,0,3,3,1,2013
Timor-Leste,Timor-Leste,Partly Free,3,4,11,12,6,29,12,7,6,9,34,63,2013
Togo,Togo,Partly Free,5,4,4,8,4,16,8,6,6,7,27,43,2013
Tonga,Tonga,Free,3,2,11,14,4,29,13,8,11,12,44,73,2013
Transnistria,Transnistria,Not Free,6,6,3,5,2,10,6,2,2,5,15,25,2013
Trinidad and Tobago,Trinidad and Tobago,Free,2,2,11,13,9,33,15,11,9,13,48,81,2013
Tunisia,Tunisia,Partly Free,3,4,9,12,5,26,10,8,6,9,33,59,2013
Turkey,Turkey,Partly Free,3,4,11,10,7,28,9,7,7,10,33,61,2013
Turkmenistan,Turkmenistan,Not Free,7,7,0,1,0,1,2,0,1,3,6,7,2013
Tuvalu,Tuvalu,Free,1,1,12,15,10,37,16,12,15,14,57,94,2013
Uganda,Uganda,Partly Free,5,4,3,6,3,12,11,4,6,7,28,40,2013
Ukraine,Ukraine,Partly Free,4,3,8,9,4,21,10,8,7,11,36,57,2013
United Arab Emirates,United Arab Emirates,Not Free,6,6,1,2,2,8,4,2,4,4,14,22,2013
United Kingdom,United Kingdom,Free,1,1,12,16,12,40,15,12,15,15,57,97,2013
United States,United States,Free,1,1,11,16,10,37,16,11,14,15,56,93,2013
Uruguay,Uruguay,Free,1,1,12,16,11,39,16,12,15,15,58,97,2013
Uzbekistan,Uzbekistan,Not Free,7,7,0,0,0,0,1,0,0,3,4,4,2013
Vanuatu,Vanuatu,Free,2,2,9,15,8,32,15,11,10,11,47,79,2013
Venezuela,Venezuela,Partly Free,5,5,5,8,2,15,9,4,4,7,24,39,2013
Vietnam,Vietnam,Not Free,7,5,0,1,1,2,4,1,4,8,17,19,2013
West Bank,West Bank,Not Free,6,5,2,5,2,6,8,6,5,5,24,30,2013
Western Sahara,Western Sahara,Not Free,7,7,0,0,0,-2,3,0,0,4,7,5,2013
Yemen,Yemen,Not Free,6,6,3,4,2,9,6,3,2,5,16,25,2013
Zambia,Zambia,Partly Free,3,4,9,12,7,28,11,7,8,8,34,62,2013
Zimbabwe,Zimbabwe,Not Free,6,6,3,5,3,11,6,3,1,4,14,25,2013